Sub_1,Sub_2,Sub_3,Sub_4,Sum,course,school,comb
6,4,0,0,10,law,Humanities,6 4 0 0 Humanities 10
7,5,1,0,13,law,Humanities,7 5 1 0 Humanities 13
6,8,0,0,14,public relations and advertising ,Humanities,6 8 0 0 Humanities 14
13,0,1,6,20,public relations and advertising ,Humanities,13 0 1 6 Humanities 20
1,7,16,2,26,media and journalism studies,Humanities,1 7 16 2 Humanities 26
0,1,6,20,27,media and journalism studies,Humanities,0 1 6 20 Humanities 27
0,15,1,18,34,linguistics and chinese,Humanities,0 15 1 18 Humanities 34
1,31,0,2,34,linguistics and chinese,Humanities,1 31 0 2 Humanities 34
0,13,12,11,36,linguistics and chinese,Humanities,0 13 12 11 Humanities 36
3,1,8,26,38,social work,Humanities,3 1 8 26 Humanities 38
21,17,1,0,39,social work,Humanities,21 17 1 0 Humanities 39
14,2,21,2,39,social work,Humanities,14 2 21 2 Humanities 39
9,9,20,1,39,social work,Humanities,9 9 20 1 Humanities 39
15,18,2,6,41,media and mass communication,Humanities,15 18 2 6 Humanities 41
11,28,1,2,42,media and mass communication,Humanities,11 28 1 2 Humanities 42
15,3,12,13,43,media and mass communication,Humanities,15 3 12 13 Humanities 43
0,4,11,28,43,media and mass communication,Humanities,0 4 11 28 Humanities 43
26,1,9,8,44,media and mass communication,Humanities,26 1 9 8 Humanities 44
11,34,0,0,45,media and mass communication,Humanities,11 34 0 0 Humanities 45
19,1,7,22,49,philosophy,Humanities,19 1 7 22 Humanities 49
0,20,16,14,50,philosophy,Humanities,0 20 16 14 Humanities 50
6,9,0,35,50,philosophy,Humanities,6 9 0 35 Humanities 50
6,22,3,20,51,demography,Humanities,6 22 3 20 Humanities 51
0,16,10,25,51,demography,Humanities,0 16 10 25 Humanities 51
15,16,16,4,51,demography,Humanities,15 16 16 4 Humanities 51
14,4,1,33,52,demography,Humanities,14 4 1 33 Humanities 52
11,26,4,11,52,demography,Humanities,11 26 4 11 Humanities 52
38,13,1,0,52,demography,Humanities,38 13 1 0 Humanities 52
8,5,24,16,53,demography,Humanities,8 5 24 16 Humanities 53
0,1,17,35,53,demography,Humanities,0 1 17 35 Humanities 53
9,25,8,12,54,phychology,Humanities,9 25 8 12 Humanities 54
24,12,2,16,54,phychology,Humanities,24 12 2 16 Humanities 54
30,9,5,10,54,phychology,Humanities,30 9 5 10 Humanities 54
9,2,13,32,56,sociology,Humanities,9 2 13 32 Humanities 56
33,15,7,2,57,sociology,Humanities,33 15 7 2 Humanities 57
0,39,2,16,57,sociology,Humanities,0 39 2 16 Humanities 57
45,4,3,5,57,sociology,Humanities,45 4 3 5 Humanities 57
33,21,1,3,58,sociology,Humanities,33 21 1 3 Humanities 58
1,16,40,1,58,sociology,Humanities,1 16 40 1 Humanities 58
41,0,13,4,58,sociology,Humanities,41 0 13 4 Humanities 58
9,36,2,12,59,sociology,Humanities,9 36 2 12 Humanities 59
9,20,1,29,59,sociology,Humanities,9 20 1 29 Humanities 59
34,3,1,21,59,sociology,Humanities,34 3 1 21 Humanities 59
11,2,45,1,59,sociology,Humanities,11 2 45 1 Humanities 59
40,2,6,11,59,sociology,Humanities,40 2 6 11 Humanities 59
1,23,30,6,60,sociology,Humanities,1 23 30 6 Humanities 60
26,7,7,20,60,sociology,Humanities,26 7 7 20 Humanities 60
46,1,12,2,61,development studies,Humanities,46 1 12 2 Humanities 61
25,2,34,0,61,development studies,Humanities,25 2 34 0 Humanities 61
0,1,26,34,61,development studies,Humanities,0 1 26 34 Humanities 61
36,14,6,5,61,development studies,Humanities,36 14 6 5 Humanities 61
0,8,18,36,62,development studies,Humanities,0 8 18 36 Humanities 62
4,3,52,3,62,development studies,Humanities,4 3 52 3 Humanities 62
13,25,23,2,63,development studies,Humanities,13 25 23 2 Humanities 63
31,1,29,2,63,development studies,Humanities,31 1 29 2 Humanities 63
3,24,3,34,64,development studies,Humanities,3 24 3 34 Humanities 64
13,11,23,17,64,development studies,Humanities,13 11 23 17 Humanities 64
31,16,16,1,64,development studies,Humanities,31 16 16 1 Humanities 64
0,3,19,42,64,development studies,Humanities,0 3 19 42 Humanities 64
9,5,2,49,65,development studies,Humanities,9 5 2 49 Humanities 65
21,1,40,3,65,development studies,Humanities,21 1 40 3 Humanities 65
11,3,48,4,66,economics,Humanities,11 3 48 4 Humanities 66
22,14,29,1,66,economics,Humanities,22 14 29 1 Humanities 66
37,11,9,9,66,economics,Humanities,37 11 9 9 Humanities 66
30,22,4,10,66,economics,Humanities,30 22 4 10 Humanities 66
22,0,42,3,67,economics,Humanities,22 0 42 3 Humanities 67
14,34,14,5,67,economics,Humanities,14 34 14 5 Humanities 67
5,7,25,30,67,economics,Humanities,5 7 25 30 Humanities 67
16,10,9,32,67,economics,Humanities,16 10 9 32 Humanities 67
20,20,3,24,67,economics,Humanities,20 20 3 24 Humanities 67
8,5,47,7,67,economics,Humanities,8 5 47 7 Humanities 67
4,52,0,12,68,economics,Humanities,4 52 0 12 Humanities 68
12,24,28,4,68,economics,Humanities,12 24 28 4 Humanities 68
2,14,3,50,69,economics,Humanities,2 14 3 50 Humanities 69
0,2,23,44,69,economics,Humanities,0 2 23 44 Humanities 69
8,27,1,34,70,economics,Humanities,8 27 1 34 Humanities 70
50,8,11,1,70,economics,Humanities,50 8 11 1 Humanities 70
0,8,47,16,71,business administration,Humanities,0 8 47 16 Humanities 71
1,37,8,25,71,business administration,Humanities,1 37 8 25 Humanities 71
3,14,6,48,71,business administration,Humanities,3 14 6 48 Humanities 71
0,45,10,18,73,business administration,Humanities,0 45 10 18 Humanities 73
6,63,1,3,73,business administration,Humanities,6 63 1 3 Humanities 73
0,7,12,54,73,business administration,Humanities,0 7 12 54 Humanities 73
20,6,4,44,74,business administration,Humanities,20 6 4 44 Humanities 74
3,24,27,21,75,business administration,Humanities,3 24 27 21 Humanities 75
52,21,0,2,75,business administration,Humanities,52 21 0 2 Humanities 75
25,13,18,19,75,business administration,Humanities,25 13 18 19 Humanities 75
51,9,12,3,75,business administration,Humanities,51 9 12 3 Humanities 75
38,11,6,20,75,business administration,Humanities,38 11 6 20 Humanities 75
8,34,31,2,75,business administration,Humanities,8 34 31 2 Humanities 75
0,14,28,33,75,business administration,Humanities,0 14 28 33 Humanities 75
35,8,7,26,76,public administration,Humanities,35 8 7 26 Humanities 76
8,1,30,37,76,public administration,Humanities,8 1 30 37 Humanities 76
10,9,11,46,76,public administration,Humanities,10 9 11 46 Humanities 76
0,22,18,36,76,public administration,Humanities,0 22 18 36 Humanities 76
10,24,21,22,77,public administration,Humanities,10 24 21 22 Humanities 77
3,6,11,57,77,public administration,Humanities,3 6 11 57 Humanities 77
33,3,40,1,77,public administration,Humanities,33 3 40 1 Humanities 77
38,20,14,5,77,public administration,Humanities,38 20 14 5 Humanities 77
50,17,4,6,77,public administration,Humanities,50 17 4 6 Humanities 77
12,4,60,2,78,public administration,Humanities,12 4 60 2 Humanities 78
9,25,17,27,78,public administration,Humanities,9 25 17 27 Humanities 78
30,14,8,26,78,public administration,Humanities,30 14 8 26 Humanities 78
8,18,0,52,78,public administration,Humanities,8 18 0 52 Humanities 78
17,30,30,2,79,public administration,Humanities,17 30 30 2 Humanities 79
0,7,55,17,79,public administration,Humanities,0 7 55 17 Humanities 79
37,30,2,10,79,public administration,Humanities,37 30 2 10 Humanities 79
1,18,13,47,79,public administration,Humanities,1 18 13 47 Humanities 79
32,10,23,15,80,public administration,Humanities,32 10 23 15 Humanities 80
60,14,5,1,80,public administration,Humanities,60 14 5 1 Humanities 80
27,28,21,4,80,public administration,Humanities,27 28 21 4 Humanities 80
33,16,14,17,80,public administration,Humanities,33 16 14 17 Humanities 80
3,74,2,1,80,public administration,Humanities,3 74 2 1 Humanities 80
4,0,1,76,81,political science,Humanities,4 0 1 76 Humanities 81
5,12,0,64,81,political science,Humanities,5 12 0 64 Humanities 81
8,27,2,44,81,political science,Humanities,8 27 2 44 Humanities 81
26,9,14,32,81,political science,Humanities,26 9 14 32 Humanities 81
27,20,22,12,81,political science,Humanities,27 20 22 12 Humanities 81
29,5,47,0,81,political science,Humanities,29 5 47 0 Humanities 81
6,13,42,21,82,political science,Humanities,6 13 42 21 Humanities 82
4,37,36,5,82,political science,Humanities,4 37 36 5 Humanities 82
32,0,33,17,82,political science,Humanities,32 0 33 17 Humanities 82
8,5,49,21,83,political science,Humanities,8 5 49 21 Humanities 83
23,42,9,9,83,political science,Humanities,23 42 9 9 Humanities 83
3,9,33,38,83,political science,Humanities,3 9 33 38 Humanities 83
22,1,19,41,83,political science,Humanities,22 1 19 41 Humanities 83
15,49,13,6,83,political science,Humanities,15 49 13 6 Humanities 83
24,36,20,3,83,political science,Humanities,24 36 20 3 Humanities 83
22,25,31,6,84,political science,Humanities,22 25 31 6 Humanities 84
20,43,13,8,84,political science,Humanities,20 43 13 8 Humanities 84
68,3,10,3,84,political science,Humanities,68 3 10 3 Humanities 84
30,0,54,0,84,political science,Humanities,30 0 54 0 Humanities 84
26,14,30,14,84,political science,Humanities,26 14 30 14 Humanities 84
12,38,10,24,84,political science,Humanities,12 38 10 24 Humanities 84
23,1,58,3,85,political science,Humanities,23 1 58 3 Humanities 85
8,14,24,39,85,political science,Humanities,8 14 24 39 Humanities 85
27,22,9,27,85,political science,Humanities,27 22 9 27 Humanities 85
10,2,54,19,85,political science,Humanities,10 2 54 19 Humanities 85
4,10,50,21,85,political science,Humanities,4 10 50 21 Humanities 85
51,11,19,4,85,political science,Humanities,51 11 19 4 Humanities 85
0,32,20,33,85,political science,Humanities,0 32 20 33 Humanities 85
0,75,8,2,85,political science,Humanities,0 75 8 2 Humanities 85
0,33,24,28,85,political science,Humanities,0 33 24 28 Humanities 85
25,3,42,16,86,science with education,Education,25 3 42 16 Education 86
39,27,10,10,86,science with education,Education,39 27 10 10 Education 86
7,30,12,37,86,science with education,Education,7 30 12 37 Education 86
1,9,5,71,86,science with education,Education,1 9 5 71 Education 86
6,0,7,73,86,science with education,Education,6 0 7 73 Education 86
18,50,16,2,86,science with education,Education,18 50 16 2 Education 86
4,16,19,48,87,science with education,Education,4 16 19 48 Education 87
22,47,1,17,87,science with education,Education,22 47 1 17 Education 87
4,14,15,54,87,science with education,Education,4 14 15 54 Education 87
12,35,39,1,87,science with education,Education,12 35 39 1 Education 87
29,23,20,15,87,science with education,Education,29 23 20 15 Education 87
57,22,2,7,88,science with education,Education,57 22 2 7 Education 88
10,25,38,15,88,science with education,Education,10 25 38 15 Education 88
11,45,27,5,88,science with education,Education,11 45 27 5 Education 88
5,13,25,45,88,science with education,Education,5 13 25 45 Education 88
25,18,29,16,88,science with education,Education,25 18 29 16 Education 88
20,28,7,33,88,science with education,Education,20 28 7 33 Education 88
10,29,20,29,88,science with education,Education,10 29 20 29 Education 88
9,25,25,29,88,science with education,Education,9 25 25 29 Education 88
4,28,3,53,88,science with education,Education,4 28 3 53 Education 88
33,27,23,5,88,science with education,Education,33 27 23 5 Education 88
38,0,3,48,89,science with education,Education,38 0 3 48 Education 89
25,18,5,41,89,science with education,Education,25 18 5 41 Education 89
20,9,57,3,89,science with education,Education,20 9 57 3 Education 89
7,23,2,57,89,science with education,Education,7 23 2 57 Education 89
0,63,0,26,89,science with education,Education,0 63 0 26 Education 89
24,4,38,24,90,science with education,Education,24 4 38 24 Education 90
75,5,7,3,90,science with education,Education,75 5 7 3 Education 90
13,21,19,37,90,science with education,Education,13 21 19 37 Education 90
23,6,46,15,90,science with education,Education,23 6 46 15 Education 90
3,15,5,67,90,science with education,Education,3 15 5 67 Education 90
0,34,9,48,91,information and communication technologies,Education,0 34 9 48 Education 91
0,3,36,52,91,information and communication technologies,Education,0 3 36 52 Education 91
16,13,48,14,91,information and communication technologies,Education,16 13 48 14 Education 91
67,3,17,4,91,information and communication technologies,Education,67 3 17 4 Education 91
30,17,38,6,91,information and communication technologies,Education,30 17 38 6 Education 91
12,27,36,16,91,information and communication technologies,Education,12 27 36 16 Education 91
25,1,41,24,91,information and communication technologies,Education,25 1 41 24 Education 91
50,15,11,15,91,information and communication technologies,Education,50 15 11 15 Education 91
10,40,10,31,91,information and communication technologies,Education,10 40 10 31 Education 91
22,38,12,19,91,information and communication technologies,Education,22 38 12 19 Education 91
27,15,43,6,91,information and communication technologies,Education,27 15 43 6 Education 91
26,21,12,33,92,information and communication technologies,Education,26 21 12 33 Education 92
20,50,0,22,92,information and communication technologies,Education,20 50 0 22 Education 92
35,29,20,8,92,information and communication technologies,Education,35 29 20 8 Education 92
61,1,8,22,92,information and communication technologies,Education,61 1 8 22 Education 92
13,9,2,68,92,information and communication technologies,Education,13 9 2 68 Education 92
12,50,17,13,92,information and communication technologies,Education,12 50 17 13 Education 92
82,3,7,0,92,information and communication technologies,Education,82 3 7 0 Education 92
2,25,27,38,92,information and communication technologies,Education,2 25 27 38 Education 92
9,48,4,31,92,information and communication technologies,Education,9 48 4 31 Education 92
7,50,35,0,92,information and communication technologies,Education,7 50 35 0 Education 92
10,8,18,56,92,information and communication technologies,Education,10 8 18 56 Education 92
64,13,5,11,93,information and communication technologies,Education,64 13 5 11 Education 93
3,62,0,28,93,information and communication technologies,Education,3 62 0 28 Education 93
28,2,19,44,93,information and communication technologies,Education,28 2 19 44 Education 93
31,8,15,39,93,information and communication technologies,Education,31 8 15 39 Education 93
55,31,1,6,93,information and communication technologies,Education,55 31 1 6 Education 93
41,11,13,28,93,information and communication technologies,Education,41 11 13 28 Education 93
0,28,28,37,93,information and communication technologies,Education,0 28 28 37 Education 93
12,40,12,29,93,information and communication technologies,Education,12 40 12 29 Education 93
5,56,12,20,93,information and communication technologies,Education,5 56 12 20 Education 93
21,21,2,50,94,information and communication technologies,Education,21 21 2 50 Education 94
13,19,2,60,94,information and communication technologies,Education,13 19 2 60 Education 94
1,23,25,45,94,information and communication technologies,Education,1 23 25 45 Education 94
20,46,15,13,94,information and communication technologies,Education,20 46 15 13 Education 94
23,31,27,13,94,information and communication technologies,Education,23 31 27 13 Education 94
11,10,15,58,94,information and communication technologies,Education,11 10 15 58 Education 94
0,19,34,41,94,information and communication technologies,Education,0 19 34 41 Education 94
50,13,11,20,94,information and communication technologies,Education,50 13 11 20 Education 94
51,1,41,1,94,information and communication technologies,Education,51 1 41 1 Education 94
51,34,5,4,94,information and communication technologies,Education,51 34 5 4 Education 94
5,42,19,28,94,information and communication technologies,Education,5 42 19 28 Education 94
5,22,31,36,94,information and communication technologies,Education,5 22 31 36 Education 94
15,11,26,43,95,information and communication technologies,Education,15 11 26 43 Education 95
0,19,42,34,95,information and communication technologies,Education,0 19 42 34 Education 95
31,47,3,14,95,information and communication technologies,Education,31 47 3 14 Education 95
15,21,47,13,96,education for primary,Education,15 21 47 13 Education 96
15,33,42,6,96,education for primary,Education,15 33 42 6 Education 96
8,50,37,1,96,education for primary,Education,8 50 37 1 Education 96
6,33,4,53,96,education for primary,Education,6 33 4 53 Education 96
50,22,12,12,96,education for primary,Education,50 22 12 12 Education 96
11,19,17,49,96,education for primary,Education,11 19 17 49 Education 96
46,15,3,32,96,education for primary,Education,46 15 3 32 Education 96
9,34,37,16,96,education for primary,Education,9 34 37 16 Education 96
9,61,11,15,96,education for primary,Education,9 61 11 15 Education 96
14,29,27,26,96,education for primary,Education,14 29 27 26 Education 96
78,6,3,10,97,education for primary,Education,78 6 3 10 Education 97
40,0,54,3,97,education for primary,Education,40 0 54 3 Education 97
2,32,28,35,97,education for primary,Education,2 32 28 35 Education 97
29,26,37,5,97,education for primary,Education,29 26 37 5 Education 97
3,9,25,60,97,education for primary,Education,3 9 25 60 Education 97
62,5,22,8,97,education for primary,Education,62 5 22 8 Education 97
0,31,0,67,98,education for primary,Education,0 31 0 67 Education 98
16,57,17,8,98,education for primary,Education,16 57 17 8 Education 98
5,6,29,58,98,education for primary,Education,5 6 29 58 Education 98
62,3,30,3,98,education for primary,Education,62 3 30 3 Education 98
62,15,16,5,98,education for primary,Education,62 15 16 5 Education 98
6,3,63,27,99,education for primary,Education,6 3 63 27 Education 99
13,42,18,26,99,education for primary,Education,13 42 18 26 Education 99
32,29,35,3,99,education for primary,Education,32 29 35 3 Education 99
24,16,5,54,99,education for primary,Education,24 16 5 54 Education 99
1,3,62,33,99,education for primary,Education,1 3 62 33 Education 99
23,35,40,1,99,education for primary,Education,23 35 40 1 Education 99
59,31,5,4,99,education for primary,Education,59 31 5 4 Education 99
13,44,25,17,99,education for primary,Education,13 44 25 17 Education 99
14,53,15,17,99,education for primary,Education,14 53 15 17 Education 99
42,18,15,24,99,education for primary,Education,42 18 15 24 Education 99
50,43,3,3,99,education for primary,Education,50 43 3 3 Education 99
45,5,1,48,99,education for primary,Education,45 5 1 48 Education 99
5,1,45,49,100,education for primary,Education,5 1 45 49 Education 100
19,23,50,8,100,education for primary,Education,19 23 50 8 Education 100
20,8,4,68,100,education for primary,Education,20 8 4 68 Education 100
72,1,21,6,100,education for primary,Education,72 1 21 6 Education 100
8,7,67,18,100,education for primary,Education,8 7 67 18 Education 100
35,4,56,5,100,education for primary,Education,35 4 56 5 Education 100
31,19,22,29,101,education for secondary,Education,31 19 22 29 Education 101
5,35,51,10,101,education for secondary,Education,5 35 51 10 Education 101
18,50,9,24,101,education for secondary,Education,18 50 9 24 Education 101
67,32,1,1,101,education for secondary,Education,67 32 1 1 Education 101
30,58,11,2,101,education for secondary,Education,30 58 11 2 Education 101
7,72,0,22,101,education for secondary,Education,7 72 0 22 Education 101
20,35,18,28,101,education for secondary,Education,20 35 18 28 Education 101
5,29,13,54,101,education for secondary,Education,5 29 13 54 Education 101
16,7,6,72,101,education for secondary,Education,16 7 6 72 Education 101
31,15,15,40,101,education for secondary,Education,31 15 15 40 Education 101
4,17,39,41,101,education for secondary,Education,4 17 39 41 Education 101
20,15,0,66,101,education for secondary,Education,20 15 0 66 Education 101
7,71,22,1,101,education for secondary,Education,7 71 22 1 Education 101
27,60,11,3,101,education for secondary,Education,27 60 11 3 Education 101
21,26,10,45,102,education for secondary,Education,21 26 10 45 Education 102
0,5,84,13,102,education for secondary,Education,0 5 84 13 Education 102
15,28,8,51,102,education for secondary,Education,15 28 8 51 Education 102
0,38,49,15,102,education for secondary,Education,0 38 49 15 Education 102
15,64,14,9,102,education for secondary,Education,15 64 14 9 Education 102
6,14,7,75,102,education for secondary,Education,6 14 7 75 Education 102
8,38,5,51,102,education for secondary,Education,8 38 5 51 Education 102
13,3,66,20,102,education for secondary,Education,13 3 66 20 Education 102
7,10,3,82,102,education for secondary,Education,7 10 3 82 Education 102
8,10,55,29,102,education for secondary,Education,8 10 55 29 Education 102
2,14,3,83,102,education for secondary,Education,2 14 3 83 Education 102
33,2,1,66,102,education for secondary,Education,33 2 1 66 Education 102
69,11,18,4,102,education for secondary,Education,69 11 18 4 Education 102
35,50,15,2,102,education for secondary,Education,35 50 15 2 Education 102
8,12,19,64,103,education for secondary,Education,8 12 19 64 Education 103
23,21,25,34,103,education for secondary,Education,23 21 25 34 Education 103
17,1,44,41,103,education for secondary,Education,17 1 44 41 Education 103
22,31,13,37,103,education for secondary,Education,22 31 13 37 Education 103
47,52,2,2,103,education for secondary,Education,47 52 2 2 Education 103
59,4,24,16,103,education for secondary,Education,59 4 24 16 Education 103
24,29,3,47,103,education for secondary,Education,24 29 3 47 Education 103
0,35,17,51,103,education for secondary,Education,0 35 17 51 Education 103
31,25,9,38,103,education for secondary,Education,31 25 9 38 Education 103
48,3,41,12,104,education for secondary,Education,48 3 41 12 Education 104
85,12,0,7,104,education for secondary,Education,85 12 0 7 Education 104
67,29,1,7,104,education for secondary,Education,67 29 1 7 Education 104
22,38,38,6,104,education for secondary,Education,22 38 38 6 Education 104
44,40,12,8,104,education for secondary,Education,44 40 12 8 Education 104
36,10,45,13,104,education for secondary,Education,36 10 45 13 Education 104
40,45,6,13,104,education for secondary,Education,40 45 6 13 Education 104
100,3,1,0,104,education for secondary,Education,100 3 1 0 Education 104
11,2,69,22,104,education for secondary,Education,11 2 69 22 Education 104
47,8,45,4,104,education for secondary,Education,47 8 45 4 Education 104
68,11,16,9,104,education for secondary,Education,68 11 16 9 Education 104
9,70,19,6,104,education for secondary,Education,9 70 19 6 Education 104
63,1,13,28,105,education for secondary,Education,63 1 13 28 Education 105
10,42,26,27,105,education for secondary,Education,10 42 26 27 Education 105
42,27,3,33,105,education for secondary,Education,42 27 3 33 Education 105
70,3,8,24,105,education for secondary,Education,70 3 8 24 Education 105
28,28,6,43,105,education for secondary,Education,28 28 6 43 Education 105
19,3,41,42,105,education for secondary,Education,19 3 41 42 Education 105
87,1,15,2,105,education for secondary,Education,87 1 15 2 Education 105
28,3,13,61,105,education for secondary,Education,28 3 13 61 Education 105
0,6,41,58,105,education for secondary,Education,0 6 41 58 Education 105
32,27,40,6,105,education for secondary,Education,32 27 40 6 Education 105
10,9,25,61,105,education for secondary,Education,10 9 25 61 Education 105
81,6,15,3,105,education for secondary,Education,81 6 15 3 Education 105
6,98,0,1,105,education for secondary,Education,6 98 0 1 Education 105
0,72,10,24,106,education of social sciences,Education,0 72 10 24 Education 106
27,28,13,38,106,education of social sciences,Education,27 28 13 38 Education 106
26,56,11,13,106,education of social sciences,Education,26 56 11 13 Education 106
12,48,25,21,106,education of social sciences,Education,12 48 25 21 Education 106
65,2,20,19,106,education of social sciences,Education,65 2 20 19 Education 106
21,19,32,34,106,education of social sciences,Education,21 19 32 34 Education 106
19,59,10,18,106,education of social sciences,Education,19 59 10 18 Education 106
1,50,0,55,106,education of social sciences,Education,1 50 0 55 Education 106
53,29,22,2,106,education of social sciences,Education,53 29 22 2 Education 106
69,19,12,6,106,education of social sciences,Education,69 19 12 6 Education 106
13,5,72,16,106,education of social sciences,Education,13 5 72 16 Education 106
51,15,41,0,107,education of social sciences,Education,51 15 41 0 Education 107
31,29,0,47,107,education of social sciences,Education,31 29 0 47 Education 107
22,11,2,72,107,education of social sciences,Education,22 11 2 72 Education 107
63,12,3,29,107,education of social sciences,Education,63 12 3 29 Education 107
30,66,7,5,108,education of social sciences,Education,30 66 7 5 Education 108
50,15,6,37,108,education of social sciences,Education,50 15 6 37 Education 108
0,6,26,76,108,education of social sciences,Education,0 6 26 76 Education 108
79,3,22,4,108,education of social sciences,Education,79 3 22 4 Education 108
0,16,8,84,108,education of social sciences,Education,0 16 8 84 Education 108
9,96,1,2,108,education of social sciences,Education,9 96 1 2 Education 108
50,26,27,5,108,education of social sciences,Education,50 26 27 5 Education 108
3,71,22,12,108,education of social sciences,Education,3 71 22 12 Education 108
45,8,27,28,108,education of social sciences,Education,45 8 27 28 Education 108
15,15,6,72,108,education of social sciences,Education,15 15 6 72 Education 108
20,28,6,55,109,education of social sciences,Education,20 28 6 55 Education 109
4,15,2,88,109,education of social sciences,Education,4 15 2 88 Education 109
14,85,7,3,109,education of social sciences,Education,14 85 7 3 Education 109
0,22,45,42,109,education of social sciences,Education,0 22 45 42 Education 109
49,1,41,18,109,education of social sciences,Education,49 1 41 18 Education 109
2,8,7,93,110,education of social sciences,Education,2 8 7 93 Education 110
44,36,9,21,110,education of social sciences,Education,44 36 9 21 Education 110
87,2,12,9,110,education of social sciences,Education,87 2 12 9 Education 110
31,26,8,45,110,education of social sciences,Education,31 26 8 45 Education 110
11,79,6,14,110,education of social sciences,Education,11 79 6 14 Education 110
13,1,2,94,110,education of social sciences,Education,13 1 2 94 Education 110
10,2,39,59,110,education of social sciences,Education,10 2 39 59 Education 110
75,1,25,9,110,education of social sciences,Education,75 1 25 9 Education 110
0,8,16,86,110,education of social sciences,Education,0 8 16 86 Education 110
50,50,3,7,110,education of social sciences,Education,50 50 3 7 Education 110
9,0,94,7,110,education of social sciences,Education,9 0 94 7 Education 110
51,20,10,29,110,education of social sciences,Education,51 20 10 29 Education 110
46,2,43,20,111,special education,Education,46 2 43 20 Education 111
23,83,4,1,111,special education,Education,23 83 4 1 Education 111
18,23,10,60,111,special education,Education,18 23 10 60 Education 111
58,8,38,7,111,special education,Education,58 8 38 7 Education 111
18,80,9,4,111,special education,Education,18 80 9 4 Education 111
26,24,18,43,111,special education,Education,26 24 18 43 Education 111
36,6,45,24,111,special education,Education,36 6 45 24 Education 111
14,87,7,3,111,special education,Education,14 87 7 3 Education 111
17,54,1,39,111,special education,Education,17 54 1 39 Education 111
2,10,18,81,111,special education,Education,2 10 18 81 Education 111
14,35,43,19,111,special education,Education,14 35 43 19 Education 111
61,0,6,44,111,special education,Education,61 0 6 44 Education 111
0,12,62,37,111,special education,Education,0 12 62 37 Education 111
73,19,15,4,111,special education,Education,73 19 15 4 Education 111
77,0,9,25,111,special education,Education,77 0 9 25 Education 111
67,0,42,3,112,special education,Education,67 0 42 3 Education 112
61,5,40,6,112,special education,Education,61 5 40 6 Education 112
63,1,44,4,112,special education,Education,63 1 44 4 Education 112
31,1,78,2,112,special education,Education,31 1 78 2 Education 112
8,79,23,2,112,special education,Education,8 79 23 2 Education 112
23,61,6,22,112,special education,Education,23 61 6 22 Education 112
17,69,15,11,112,special education,Education,17 69 15 11 Education 112
67,2,39,4,112,special education,Education,67 2 39 4 Education 112
11,97,3,1,112,special education,Education,11 97 3 1 Education 112
0,9,83,20,112,special education,Education,0 9 83 20 Education 112
27,0,10,75,112,special education,Education,27 0 10 75 Education 112
2,16,31,63,112,special education,Education,2 16 31 63 Education 112
19,61,21,11,112,special education,Education,19 61 21 11 Education 112
78,7,3,24,112,special education,Education,78 7 3 24 Education 112
29,25,14,45,113,special education,Education,29 25 14 45 Education 113
14,23,33,43,113,special education,Education,14 23 33 43 Education 113
0,5,24,84,113,special education,Education,0 5 24 84 Education 113
3,13,4,93,113,special education,Education,3 13 4 93 Education 113
0,5,67,41,113,special education,Education,0 5 67 41 Education 113
38,34,34,7,113,special education,Education,38 34 34 7 Education 113
13,42,27,31,113,special education,Education,13 42 27 31 Education 113
77,7,18,11,113,special education,Education,77 7 18 11 Education 113
37,21,5,50,113,special education,Education,37 21 5 50 Education 113
34,20,48,11,113,special education,Education,34 20 48 11 Education 113
72,12,26,3,113,special education,Education,72 12 26 3 Education 113
14,23,19,57,113,special education,Education,14 23 19 57 Education 113
0,38,20,55,113,special education,Education,0 38 20 55 Education 113
0,17,1,96,114,special education,Education,0 17 1 96 Education 114
60,15,20,19,114,special education,Education,60 15 20 19 Education 114
20,92,2,0,114,special education,Education,20 92 2 0 Education 114
64,12,15,23,114,special education,Education,64 12 15 23 Education 114
5,7,6,96,114,special education,Education,5 7 6 96 Education 114
13,14,26,61,114,special education,Education,13 14 26 61 Education 114
15,59,20,20,114,special education,Education,15 59 20 20 Education 114
43,4,2,65,114,special education,Education,43 4 2 65 Education 114
49,12,13,40,114,special education,Education,49 12 13 40 Education 114
14,57,12,31,114,special education,Education,14 57 12 31 Education 114
7,13,4,90,114,special education,Education,7 13 4 90 Education 114
27,69,8,10,114,special education,Education,27 69 8 10 Education 114
10,21,17,66,114,special education,Education,10 21 17 66 Education 114
25,19,21,50,115,special education,Education,25 19 21 50 Education 115
6,76,31,2,115,special education,Education,6 76 31 2 Education 115
43,25,29,18,115,special education,Education,43 25 29 18 Education 115
21,51,13,30,115,special education,Education,21 51 13 30 Education 115
29,3,21,62,115,special education,Education,29 3 21 62 Education 115
48,18,2,47,115,special education,Education,48 18 2 47 Education 115
11,5,59,40,115,special education,Education,11 5 59 40 Education 115
0,1,40,74,115,special education,Education,0 1 40 74 Education 115
17,74,16,8,115,special education,Education,17 74 16 8 Education 115
23,5,75,12,115,special education,Education,23 5 75 12 Education 115
86,1,8,20,115,special education,Education,86 1 8 20 Education 115
22,65,0,28,115,special education,Education,22 65 0 28 Education 115
66,22,9,18,115,special education,Education,66 22 9 18 Education 115
44,12,56,3,115,special education,Education,44 12 56 3 Education 115
4,30,48,33,115,special education,Education,4 30 48 33 Education 115
7,40,20,48,115,special education,Education,7 40 20 48 Education 115
12,46,28,29,115,special education,Education,12 46 28 29 Education 115
61,9,41,4,115,special education,Education,61 9 41 4 Education 115
6,4,95,10,115,special education,Education,6 4 95 10 Education 115
26,63,25,2,116,sociology of education,Education,26 63 25 2 Education 116
28,25,29,34,116,sociology of education,Education,28 25 29 34 Education 116
50,13,36,17,116,sociology of education,Education,50 13 36 17 Education 116
2,50,31,33,116,sociology of education,Education,2 50 31 33 Education 116
34,12,9,61,116,sociology of education,Education,34 12 9 61 Education 116
70,6,9,31,116,sociology of education,Education,70 6 9 31 Education 116
44,50,22,0,116,sociology of education,Education,44 50 22 0 Education 116
58,5,41,12,116,sociology of education,Education,58 5 41 12 Education 116
27,50,21,18,116,sociology of education,Education,27 50 21 18 Education 116
2,96,6,12,116,sociology of education,Education,2 96 6 12 Education 116
11,66,18,21,116,sociology of education,Education,11 66 18 21 Education 116
52,45,10,9,116,sociology of education,Education,52 45 10 9 Education 116
18,6,40,52,116,sociology of education,Education,18 6 40 52 Education 116
8,9,6,93,116,sociology of education,Education,8 9 6 93 Education 116
48,12,30,26,116,sociology of education,Education,48 12 30 26 Education 116
0,3,33,80,116,sociology of education,Education,0 3 33 80 Education 116
12,17,19,68,116,sociology of education,Education,12 17 19 68 Education 116
87,17,4,8,116,sociology of education,Education,87 17 4 8 Education 116
15,8,91,2,116,sociology of education,Education,15 8 91 2 Education 116
0,17,59,40,116,sociology of education,Education,0 17 59 40 Education 116
0,16,71,29,116,sociology of education,Education,0 16 71 29 Education 116
59,1,6,51,117,sociology of education,Education,59 1 6 51 Education 117
17,15,8,77,117,sociology of education,Education,17 15 8 77 Education 117
42,14,27,34,117,sociology of education,Education,42 14 27 34 Education 117
0,27,28,62,117,sociology of education,Education,0 27 28 62 Education 117
36,7,2,72,117,sociology of education,Education,36 7 2 72 Education 117
9,6,14,88,117,sociology of education,Education,9 6 14 88 Education 117
100,8,6,3,117,sociology of education,Education,100 8 6 3 Education 117
24,8,13,72,117,sociology of education,Education,24 8 13 72 Education 117
34,15,9,59,117,sociology of education,Education,34 15 9 59 Education 117
3,31,9,74,117,sociology of education,Education,3 31 9 74 Education 117
5,73,10,29,117,sociology of education,Education,5 73 10 29 Education 117
81,3,11,22,117,sociology of education,Education,81 3 11 22 Education 117
38,31,28,20,117,sociology of education,Education,38 31 28 20 Education 117
18,67,8,24,117,sociology of education,Education,18 67 8 24 Education 117
7,6,51,53,117,sociology of education,Education,7 6 51 53 Education 117
75,0,22,20,117,sociology of education,Education,75 0 22 20 Education 117
28,77,11,1,117,sociology of education,Education,28 77 11 1 Education 117
13,28,10,67,118,sociology of education,Education,13 28 10 67 Education 118
43,0,62,13,118,sociology of education,Education,43 0 62 13 Education 118
50,38,6,24,118,sociology of education,Education,50 38 6 24 Education 118
6,7,52,53,118,sociology of education,Education,6 7 52 53 Education 118
12,27,30,49,118,sociology of education,Education,12 27 30 49 Education 118
27,30,22,39,118,sociology of education,Education,27 30 22 39 Education 118
41,41,20,16,118,sociology of education,Education,41 41 20 16 Education 118
23,28,6,61,118,sociology of education,Education,23 28 6 61 Education 118
50,8,22,38,118,sociology of education,Education,50 8 22 38 Education 118
31,5,33,49,118,sociology of education,Education,31 5 33 49 Education 118
25,67,6,20,118,sociology of education,Education,25 67 6 20 Education 118
36,7,53,22,118,sociology of education,Education,36 7 53 22 Education 118
58,40,18,2,118,sociology of education,Education,58 40 18 2 Education 118
54,0,38,26,118,sociology of education,Education,54 0 38 26 Education 118
46,51,13,8,118,sociology of education,Education,46 51 13 8 Education 118
14,94,6,4,118,sociology of education,Education,14 94 6 4 Education 118
6,61,4,47,118,sociology of education,Education,6 61 4 47 Education 118
1,34,33,51,119,sociology of education,Education,1 34 33 51 Education 119
1,50,63,5,119,sociology of education,Education,1 50 63 5 Education 119
8,43,32,36,119,sociology of education,Education,8 43 32 36 Education 119
33,64,13,9,119,sociology of education,Education,33 64 13 9 Education 119
30,18,3,68,119,sociology of education,Education,30 18 3 68 Education 119
44,68,2,5,119,sociology of education,Education,44 68 2 5 Education 119
68,33,6,12,119,sociology of education,Education,68 33 6 12 Education 119
0,95,0,24,119,sociology of education,Education,0 95 0 24 Education 119
78,9,16,16,119,sociology of education,Education,78 9 16 16 Education 119
13,37,3,66,119,sociology of education,Education,13 37 3 66 Education 119
37,7,37,38,119,sociology of education,Education,37 7 37 38 Education 119
31,45,13,30,119,sociology of education,Education,31 45 13 30 Education 119
86,8,19,6,119,sociology of education,Education,86 8 19 6 Education 119
50,0,54,15,119,sociology of education,Education,50 0 54 15 Education 119
24,14,5,76,119,sociology of education,Education,24 14 5 76 Education 119
10,26,31,52,119,sociology of education,Education,10 26 31 52 Education 119
6,3,11,99,119,sociology of education,Education,6 3 11 99 Education 119
57,20,40,2,119,sociology of education,Education,57 20 40 2 Education 119
14,45,18,42,119,sociology of education,Education,14 45 18 42 Education 119
76,26,12,5,119,sociology of education,Education,76 26 12 5 Education 119
10,58,5,47,120,sociology of education,Education,10 58 5 47 Education 120
21,36,16,47,120,sociology of education,Education,21 36 16 47 Education 120
51,0,68,1,120,sociology of education,Education,51 0 68 1 Education 120
40,41,9,30,120,sociology of education,Education,40 41 9 30 Education 120
23,26,30,41,120,sociology of education,Education,23 26 30 41 Education 120
31,31,14,44,120,sociology of education,Education,31 31 14 44 Education 120
3,66,1,50,120,sociology of education,Education,3 66 1 50 Education 120
56,11,47,6,120,sociology of education,Education,56 11 47 6 Education 120
9,46,3,62,120,sociology of education,Education,9 46 3 62 Education 120
36,73,9,2,120,sociology of education,Education,36 73 9 2 Education 120
35,22,58,6,121,literacy and language,Education,35 22 58 6 Education 121
71,15,11,24,121,literacy and language,Education,71 15 11 24 Education 121
45,9,12,55,121,literacy and language,Education,45 9 12 55 Education 121
8,19,14,80,121,literacy and language,Education,8 19 14 80 Education 121
3,0,31,87,121,literacy and language,Education,3 0 31 87 Education 121
48,9,21,43,121,literacy and language,Education,48 9 21 43 Education 121
50,69,2,0,121,literacy and language,Education,50 69 2 0 Education 121
30,3,31,57,121,literacy and language,Education,30 3 31 57 Education 121
41,18,33,29,121,literacy and language,Education,41 18 33 29 Education 121
67,22,0,32,121,literacy and language,Education,67 22 0 32 Education 121
5,90,22,5,122,literacy and language,Education,5 90 22 5 Education 122
74,2,20,26,122,literacy and language,Education,74 2 20 26 Education 122
62,9,16,35,122,literacy and language,Education,62 9 16 35 Education 122
9,17,70,26,122,literacy and language,Education,9 17 70 26 Education 122
0,26,43,53,122,literacy and language,Education,0 26 43 53 Education 122
56,49,5,12,122,literacy and language,Education,56 49 5 12 Education 122
2,6,33,81,122,literacy and language,Education,2 6 33 81 Education 122
4,57,12,49,122,literacy and language,Education,4 57 12 49 Education 122
6,66,33,17,122,literacy and language,Education,6 66 33 17 Education 122
50,4,64,4,122,literacy and language,Education,50 4 64 4 Education 122
17,50,40,15,122,literacy and language,Education,17 50 40 15 Education 122
100,1,15,6,122,literacy and language,Education,100 1 15 6 Education 122
35,50,9,28,122,literacy and language,Education,35 50 9 28 Education 122
26,11,85,0,122,literacy and language,Education,26 11 85 0 Education 122
0,6,84,32,122,literacy and language,Education,0 6 84 32 Education 122
0,13,9,100,122,literacy and language,Education,0 13 9 100 Education 122
35,20,39,28,122,literacy and language,Education,35 20 39 28 Education 122
2,26,5,89,122,literacy and language,Education,2 26 5 89 Education 122
55,26,22,19,122,literacy and language,Education,55 26 22 19 Education 122
13,12,9,88,122,literacy and language,Education,13 12 9 88 Education 122
90,7,7,19,123,literacy and language,Education,90 7 7 19 Education 123
8,74,36,5,123,literacy and language,Education,8 74 36 5 Education 123
37,61,1,24,123,literacy and language,Education,37 61 1 24 Education 123
11,3,18,91,123,literacy and language,Education,11 3 18 91 Education 123
14,31,33,45,123,literacy and language,Education,14 31 33 45 Education 123
0,3,78,42,123,literacy and language,Education,0 3 78 42 Education 123
47,69,2,5,123,literacy and language,Education,47 69 2 5 Education 123
0,59,33,31,123,literacy and language,Education,0 59 33 31 Education 123
0,21,48,54,123,literacy and language,Education,0 21 48 54 Education 123
27,30,52,14,123,literacy and language,Education,27 30 52 14 Education 123
23,10,3,87,123,literacy and language,Education,23 10 3 87 Education 123
48,50,0,25,123,literacy and language,Education,48 50 0 25 Education 123
4,49,41,29,123,literacy and language,Education,4 49 41 29 Education 123
12,61,36,14,123,literacy and language,Education,12 61 36 14 Education 123
15,32,22,54,123,literacy and language,Education,15 32 22 54 Education 123
4,37,74,8,123,literacy and language,Education,4 37 74 8 Education 123
11,63,9,41,124,literacy and language,Education,11 63 9 41 Education 124
17,8,12,87,124,literacy and language,Education,17 8 12 87 Education 124
55,6,41,22,124,literacy and language,Education,55 6 41 22 Education 124
0,72,22,30,124,literacy and language,Education,0 72 22 30 Education 124
24,24,51,25,124,literacy and language,Education,24 24 51 25 Education 124
97,16,2,9,124,literacy and language,Education,97 16 2 9 Education 124
45,15,50,14,124,literacy and language,Education,45 15 50 14 Education 124
32,18,51,23,124,literacy and language,Education,32 18 51 23 Education 124
3,16,51,54,124,literacy and language,Education,3 16 51 54 Education 124
33,6,26,59,124,literacy and language,Education,33 6 26 59 Education 124
35,23,26,40,124,literacy and language,Education,35 23 26 40 Education 124
31,6,68,19,124,literacy and language,Education,31 6 68 19 Education 124
32,59,15,18,124,literacy and language,Education,32 59 15 18 Education 124
0,5,47,72,124,literacy and language,Education,0 5 47 72 Education 124
31,77,6,10,124,literacy and language,Education,31 77 6 10 Education 124
0,16,9,99,124,literacy and language,Education,0 16 9 99 Education 124
5,73,3,44,125,literacy and language,Education,5 73 3 44 Education 125
49,2,55,19,125,literacy and language,Education,49 2 55 19 Education 125
21,16,44,44,125,literacy and language,Education,21 16 44 44 Education 125
66,48,4,7,125,literacy and language,Education,66 48 4 7 Education 125
83,17,16,9,125,literacy and language,Education,83 17 16 9 Education 125
84,26,8,7,125,literacy and language,Education,84 26 8 7 Education 125
19,50,8,48,125,literacy and language,Education,19 50 8 48 Education 125
39,17,13,56,125,literacy and language,Education,39 17 13 56 Education 125
22,10,25,68,125,literacy and language,Education,22 10 25 68 Education 125
48,2,60,15,125,literacy and language,Education,48 2 60 15 Education 125
49,6,18,52,125,literacy and language,Education,49 6 18 52 Education 125
0,25,2,98,125,literacy and language,Education,0 25 2 98 Education 125
14,35,36,40,125,literacy and language,Education,14 35 36 40 Education 125
5,81,13,26,125,literacy and language,Education,5 81 13 26 Education 125
15,11,78,21,125,literacy and language,Education,15 11 78 21 Education 125
0,25,40,60,125,literacy and language,Education,0 25 40 60 Education 125
26,4,15,80,125,literacy and language,Education,26 4 15 80 Education 125
7,9,21,88,125,literacy and language,Education,7 9 21 88 Education 125
42,1,33,49,125,literacy and language,Education,42 1 33 49 Education 125
0,6,55,64,125,literacy and language,Education,0 6 55 64 Education 125
34,22,7,62,125,literacy and language,Education,34 22 7 62 Education 125
19,14,58,35,126,educational administration and management,Humanities,19 14 58 35 Humanities 126
100,2,4,20,126,educational administration and management,Humanities,100 2 4 20 Humanities 126
0,4,70,52,126,educational administration and management,Humanities,0 4 70 52 Humanities 126
36,46,11,33,126,educational administration and management,Humanities,36 46 11 33 Humanities 126
93,14,2,17,126,educational administration and management,Humanities,93 14 2 17 Humanities 126
0,54,26,46,126,educational administration and management,Humanities,0 54 26 46 Humanities 126
21,22,36,47,126,educational administration and management,Humanities,21 22 36 47 Humanities 126
0,32,67,27,126,educational administration and management,Humanities,0 32 67 27 Humanities 126
0,9,99,18,126,educational administration and management,Humanities,0 9 99 18 Humanities 126
2,90,2,32,126,educational administration and management,Humanities,2 90 2 32 Humanities 126
16,72,37,1,126,educational administration and management,Humanities,16 72 37 1 Humanities 126
66,13,18,29,126,educational administration and management,Humanities,66 13 18 29 Humanities 126
23,40,23,40,126,educational administration and management,Humanities,23 40 23 40 Humanities 126
10,83,8,25,126,educational administration and management,Humanities,10 83 8 25 Humanities 126
55,11,26,34,126,educational administration and management,Humanities,55 11 26 34 Humanities 126
63,40,6,17,126,educational administration and management,Humanities,63 40 6 17 Humanities 126
3,42,70,11,126,educational administration and management,Humanities,3 42 70 11 Humanities 126
22,45,7,52,126,educational administration and management,Humanities,22 45 7 52 Humanities 126
2,4,63,57,126,educational administration and management,Humanities,2 4 63 57 Humanities 126
16,8,20,83,127,educational administration and management,Humanities,16 8 20 83 Humanities 127
10,19,71,27,127,educational administration and management,Humanities,10 19 71 27 Humanities 127
53,11,15,48,127,educational administration and management,Humanities,53 11 15 48 Humanities 127
50,33,12,32,127,educational administration and management,Humanities,50 33 12 32 Humanities 127
8,43,43,33,127,educational administration and management,Humanities,8 43 43 33 Humanities 127
43,55,9,20,127,educational administration and management,Humanities,43 55 9 20 Humanities 127
18,83,18,8,127,educational administration and management,Humanities,18 83 18 8 Humanities 127
6,72,0,49,127,educational administration and management,Humanities,6 72 0 49 Humanities 127
27,16,68,16,127,educational administration and management,Humanities,27 16 68 16 Humanities 127
48,61,7,11,127,educational administration and management,Humanities,48 61 7 11 Humanities 127
50,50,27,0,127,educational administration and management,Humanities,50 50 27 0 Humanities 127
77,11,26,13,127,educational administration and management,Humanities,77 11 26 13 Humanities 127
16,35,17,59,127,educational administration and management,Humanities,16 35 17 59 Humanities 127
13,43,38,34,128,educational administration and management,Humanities,13 43 38 34 Humanities 128
78,0,3,47,128,educational administration and management,Humanities,78 0 3 47 Humanities 128
71,2,42,13,128,educational administration and management,Humanities,71 2 42 13 Humanities 128
12,22,15,79,128,educational administration and management,Humanities,12 22 15 79 Humanities 128
16,79,20,13,128,educational administration and management,Humanities,16 79 20 13 Humanities 128
6,46,28,48,128,educational administration and management,Humanities,6 46 28 48 Humanities 128
7,71,3,47,128,educational administration and management,Humanities,7 71 3 47 Humanities 128
14,55,20,39,128,educational administration and management,Humanities,14 55 20 39 Humanities 128
33,69,11,15,128,educational administration and management,Humanities,33 69 11 15 Humanities 128
35,60,15,18,128,educational administration and management,Humanities,35 60 15 18 Humanities 128
15,83,6,24,128,educational administration and management,Humanities,15 83 6 24 Humanities 128
58,6,11,53,128,educational administration and management,Humanities,58 6 11 53 Humanities 128
17,38,50,23,128,educational administration and management,Humanities,17 38 50 23 Humanities 128
38,51,35,4,128,educational administration and management,Humanities,38 51 35 4 Humanities 128
15,8,39,66,128,educational administration and management,Humanities,15 8 39 66 Humanities 128
25,24,12,67,128,educational administration and management,Humanities,25 24 12 67 Humanities 128
40,4,19,65,128,educational administration and management,Humanities,40 4 19 65 Humanities 128
30,34,11,53,128,educational administration and management,Humanities,30 34 11 53 Humanities 128
45,16,33,34,128,educational administration and management,Humanities,45 16 33 34 Humanities 128
11,3,88,26,128,educational administration and management,Humanities,11 3 88 26 Humanities 128
54,18,14,43,129,educational administration and management,Humanities,54 18 14 43 Humanities 129
40,30,52,7,129,educational administration and management,Humanities,40 30 52 7 Humanities 129
39,27,20,43,129,educational administration and management,Humanities,39 27 20 43 Humanities 129
4,92,0,33,129,educational administration and management,Humanities,4 92 0 33 Humanities 129
16,38,38,37,129,educational administration and management,Humanities,16 38 38 37 Humanities 129
40,73,8,8,129,educational administration and management,Humanities,40 73 8 8 Humanities 129
29,64,14,22,129,educational administration and management,Humanities,29 64 14 22 Humanities 129
68,16,21,24,129,educational administration and management,Humanities,68 16 21 24 Humanities 129
0,13,66,50,129,educational administration and management,Humanities,0 13 66 50 Humanities 129
25,74,23,7,129,educational administration and management,Humanities,25 74 23 7 Humanities 129
33,26,18,52,129,educational administration and management,Humanities,33 26 18 52 Humanities 129
31,19,58,21,129,educational administration and management,Humanities,31 19 58 21 Humanities 129
8,11,78,32,129,educational administration and management,Humanities,8 11 78 32 Humanities 129
6,99,6,18,129,educational administration and management,Humanities,6 99 6 18 Humanities 129
30,11,5,83,129,educational administration and management,Humanities,30 11 5 83 Humanities 129
13,30,3,83,129,educational administration and management,Humanities,13 30 3 83 Humanities 129
45,10,34,40,129,educational administration and management,Humanities,45 10 34 40 Humanities 129
48,11,3,67,129,educational administration and management,Humanities,48 11 3 67 Humanities 129
4,25,9,91,129,educational administration and management,Humanities,4 25 9 91 Humanities 129
0,87,9,33,129,educational administration and management,Humanities,0 87 9 33 Humanities 129
23,50,50,7,130,educational administration and management,Humanities,23 50 50 7 Humanities 130
0,71,29,30,130,educational administration and management,Humanities,0 71 29 30 Humanities 130
27,9,45,49,130,educational administration and management,Humanities,27 9 45 49 Humanities 130
57,13,27,33,130,educational administration and management,Humanities,57 13 27 33 Humanities 130
15,13,13,89,130,educational administration and management,Humanities,15 13 13 89 Humanities 130
50,22,2,56,130,educational administration and management,Humanities,50 22 2 56 Humanities 130
86,2,14,28,130,educational administration and management,Humanities,86 2 14 28 Humanities 130
35,91,3,1,130,educational administration and management,Humanities,35 91 3 1 Humanities 130
22,39,21,48,130,educational administration and management,Humanities,22 39 21 48 Humanities 130
28,7,30,65,130,educational administration and management,Humanities,28 7 30 65 Humanities 130
37,18,31,44,130,educational administration and management,Humanities,37 18 31 44 Humanities 130
17,37,36,40,130,educational administration and management,Humanities,17 37 36 40 Humanities 130
62,2,64,2,130,educational administration and management,Humanities,62 2 64 2 Humanities 130
11,1,32,86,130,educational administration and management,Humanities,11 1 32 86 Humanities 130
27,57,34,12,130,educational administration and management,Humanities,27 57 34 12 Humanities 130
59,16,51,4,130,educational administration and management,Humanities,59 16 51 4 Humanities 130
27,71,26,6,130,educational administration and management,Humanities,27 71 26 6 Humanities 130
1,70,49,10,130,educational administration and management,Humanities,1 70 49 10 Humanities 130
40,6,73,11,130,educational administration and management,Humanities,40 6 73 11 Humanities 130
11,32,7,80,130,educational administration and management,Humanities,11 32 7 80 Humanities 130
16,37,30,47,130,educational administration and management,Humanities,16 37 30 47 Humanities 130
12,51,41,26,130,educational administration and management,Humanities,12 51 41 26 Humanities 130
11,37,30,52,130,educational administration and management,Humanities,11 37 30 52 Humanities 130
13,25,35,57,130,educational administration and management,Humanities,13 25 35 57 Humanities 130
95,13,12,10,130,educational administration and management,Humanities,95 13 12 10 Humanities 130
46,56,13,16,131,enviromental education,Humanities,46 56 13 16 Humanities 131
34,46,28,23,131,enviromental education,Humanities,34 46 28 23 Humanities 131
39,17,35,40,131,enviromental education,Humanities,39 17 35 40 Humanities 131
38,30,57,6,131,enviromental education,Humanities,38 30 57 6 Humanities 131
2,0,65,64,131,enviromental education,Humanities,2 0 65 64 Humanities 131
8,34,47,42,131,enviromental education,Humanities,8 34 47 42 Humanities 131
23,32,8,68,131,enviromental education,Humanities,23 32 8 68 Humanities 131
82,34,9,6,131,enviromental education,Humanities,82 34 9 6 Humanities 131
55,67,1,8,131,enviromental education,Humanities,55 67 1 8 Humanities 131
84,0,9,38,131,enviromental education,Humanities,84 0 9 38 Humanities 131
61,44,16,10,131,enviromental education,Humanities,61 44 16 10 Humanities 131
20,34,25,52,131,enviromental education,Humanities,20 34 25 52 Humanities 131
0,15,58,58,131,enviromental education,Humanities,0 15 58 58 Humanities 131
14,16,4,97,131,enviromental education,Humanities,14 16 4 97 Humanities 131
0,78,7,46,131,enviromental education,Humanities,0 78 7 46 Humanities 131
53,35,7,36,131,enviromental education,Humanities,53 35 7 36 Humanities 131
58,16,18,39,131,enviromental education,Humanities,58 16 18 39 Humanities 131
19,84,10,18,131,enviromental education,Humanities,19 84 10 18 Humanities 131
5,6,53,68,132,enviromental education,Humanities,5 6 53 68 Humanities 132
58,50,5,19,132,enviromental education,Humanities,58 50 5 19 Humanities 132
46,3,65,18,132,enviromental education,Humanities,46 3 65 18 Humanities 132
88,4,38,2,132,enviromental education,Humanities,88 4 38 2 Humanities 132
56,21,25,30,132,enviromental education,Humanities,56 21 25 30 Humanities 132
19,35,44,34,132,enviromental education,Humanities,19 35 44 34 Humanities 132
63,0,38,31,132,enviromental education,Humanities,63 0 38 31 Humanities 132
72,4,26,30,132,enviromental education,Humanities,72 4 26 30 Humanities 132
70,42,7,13,132,enviromental education,Humanities,70 42 7 13 Humanities 132
58,44,24,6,132,enviromental education,Humanities,58 44 24 6 Humanities 132
23,44,33,32,132,enviromental education,Humanities,23 44 33 32 Humanities 132
48,11,25,48,132,enviromental education,Humanities,48 11 25 48 Humanities 132
25,13,48,46,132,enviromental education,Humanities,25 13 48 46 Humanities 132
74,0,48,10,132,enviromental education,Humanities,74 0 48 10 Humanities 132
35,26,23,49,133,enviromental education,Humanities,35 26 23 49 Humanities 133
14,71,36,12,133,enviromental education,Humanities,14 71 36 12 Humanities 133
0,19,35,79,133,enviromental education,Humanities,0 19 35 79 Humanities 133
61,66,1,5,133,enviromental education,Humanities,61 66 1 5 Humanities 133
24,10,6,93,133,enviromental education,Humanities,24 10 6 93 Humanities 133
77,53,2,1,133,enviromental education,Humanities,77 53 2 1 Humanities 133
59,57,7,10,133,enviromental education,Humanities,59 57 7 10 Humanities 133
8,6,60,59,133,enviromental education,Humanities,8 6 60 59 Humanities 133
49,38,21,25,133,enviromental education,Humanities,49 38 21 25 Humanities 133
12,16,54,51,133,enviromental education,Humanities,12 16 54 51 Humanities 133
51,6,36,40,133,enviromental education,Humanities,51 6 36 40 Humanities 133
28,36,36,33,133,enviromental education,Humanities,28 36 36 33 Humanities 133
49,54,11,19,133,enviromental education,Humanities,49 54 11 19 Humanities 133
52,31,22,28,133,enviromental education,Humanities,52 31 22 28 Humanities 133
42,56,21,14,133,enviromental education,Humanities,42 56 21 14 Humanities 133
34,76,6,17,133,enviromental education,Humanities,34 76 6 17 Humanities 133
49,23,41,20,133,enviromental education,Humanities,49 23 41 20 Humanities 133
6,52,34,41,133,enviromental education,Humanities,6 52 34 41 Humanities 133
74,7,13,39,133,enviromental education,Humanities,74 7 13 39 Humanities 133
0,31,10,92,133,enviromental education,Humanities,0 31 10 92 Humanities 133
28,44,12,49,133,enviromental education,Humanities,28 44 12 49 Humanities 133
43,3,5,82,133,enviromental education,Humanities,43 3 5 82 Humanities 133
13,48,17,55,133,enviromental education,Humanities,13 48 17 55 Humanities 133
41,6,21,65,133,enviromental education,Humanities,41 6 21 65 Humanities 133
49,19,14,51,133,enviromental education,Humanities,49 19 14 51 Humanities 133
9,51,4,70,134,enviromental education,Humanities,9 51 4 70 Humanities 134
71,46,8,9,134,enviromental education,Humanities,71 46 8 9 Humanities 134
25,73,16,20,134,enviromental education,Humanities,25 73 16 20 Humanities 134
71,11,35,17,134,enviromental education,Humanities,71 11 35 17 Humanities 134
94,10,21,9,134,enviromental education,Humanities,94 10 21 9 Humanities 134
37,3,50,44,134,enviromental education,Humanities,37 3 50 44 Humanities 134
25,28,23,58,134,enviromental education,Humanities,25 28 23 58 Humanities 134
30,12,1,91,134,enviromental education,Humanities,30 12 1 91 Humanities 134
55,5,58,16,134,enviromental education,Humanities,55 5 58 16 Humanities 134
26,23,16,69,134,enviromental education,Humanities,26 23 16 69 Humanities 134
30,10,18,76,134,enviromental education,Humanities,30 10 18 76 Humanities 134
24,50,2,58,134,enviromental education,Humanities,24 50 2 58 Humanities 134
41,13,70,10,134,enviromental education,Humanities,41 13 70 10 Humanities 134
12,55,48,19,134,enviromental education,Humanities,12 55 48 19 Humanities 134
36,50,20,28,134,enviromental education,Humanities,36 50 20 28 Humanities 134
64,50,20,0,134,enviromental education,Humanities,64 50 20 0 Humanities 134
10,6,76,43,135,enviromental education,Humanities,10 6 76 43 Humanities 135
5,5,36,89,135,enviromental education,Humanities,5 5 36 89 Humanities 135
12,28,8,87,135,enviromental education,Humanities,12 28 8 87 Humanities 135
37,24,18,56,135,enviromental education,Humanities,37 24 18 56 Humanities 135
65,5,9,56,135,enviromental education,Humanities,65 5 9 56 Humanities 135
28,97,10,0,135,enviromental education,Humanities,28 97 10 0 Humanities 135
6,22,18,89,135,enviromental education,Humanities,6 22 18 89 Humanities 135
57,36,30,12,135,enviromental education,Humanities,57 36 30 12 Humanities 135
32,27,37,39,135,enviromental education,Humanities,32 27 37 39 Humanities 135
83,23,19,10,135,enviromental education,Humanities,83 23 19 10 Humanities 135
0,20,90,25,135,enviromental education,Humanities,0 20 90 25 Humanities 135
1,37,72,25,135,enviromental education,Humanities,1 37 72 25 Humanities 135
57,5,35,38,135,enviromental education,Humanities,57 5 35 38 Humanities 135
19,19,16,81,135,enviromental education,Humanities,19 19 16 81 Humanities 135
36,56,10,33,135,enviromental education,Humanities,36 56 10 33 Humanities 135
78,47,3,7,135,enviromental education,Humanities,78 47 3 7 Humanities 135
70,19,23,23,135,enviromental education,Humanities,70 19 23 23 Humanities 135
42,16,1,76,135,enviromental education,Humanities,42 16 1 76 Humanities 135
16,41,25,53,135,enviromental education,Humanities,16 41 25 53 Humanities 135
50,50,4,31,135,enviromental education,Humanities,50 50 4 31 Humanities 135
25,67,20,23,135,enviromental education,Humanities,25 67 20 23 Humanities 135
27,58,21,29,135,enviromental education,Humanities,27 58 21 29 Humanities 135
56,60,6,13,135,enviromental education,Humanities,56 60 6 13 Humanities 135
74,3,28,30,135,enviromental education,Humanities,74 3 28 30 Humanities 135
41,56,29,10,136,educational phychology,Education,41 56 29 10 Education 136
80,36,5,15,136,educational phychology,Education,80 36 5 15 Education 136
0,25,96,15,136,educational phychology,Education,0 25 96 15 Education 136
46,0,66,24,136,educational phychology,Education,46 0 66 24 Education 136
83,8,36,9,136,educational phychology,Education,83 8 36 9 Education 136
72,19,13,32,136,educational phychology,Education,72 19 13 32 Education 136
88,39,6,3,136,educational phychology,Education,88 39 6 3 Education 136
0,50,19,67,136,educational phychology,Education,0 50 19 67 Education 136
99,1,32,4,136,educational phychology,Education,99 1 32 4 Education 136
26,29,19,62,136,educational phychology,Education,26 29 19 62 Education 136
59,63,3,11,136,educational phychology,Education,59 63 3 11 Education 136
26,35,17,58,136,educational phychology,Education,26 35 17 58 Education 136
79,45,4,8,136,educational phychology,Education,79 45 4 8 Education 136
0,57,35,44,136,educational phychology,Education,0 57 35 44 Education 136
38,31,31,36,136,educational phychology,Education,38 31 31 36 Education 136
36,9,22,69,136,educational phychology,Education,36 9 22 69 Education 136
45,13,50,28,136,educational phychology,Education,45 13 50 28 Education 136
19,35,22,60,136,educational phychology,Education,19 35 22 60 Education 136
28,80,12,17,137,educational phychology,Education,28 80 12 17 Education 137
33,56,46,2,137,educational phychology,Education,33 56 46 2 Education 137
11,44,32,50,137,educational phychology,Education,11 44 32 50 Education 137
50,4,49,34,137,educational phychology,Education,50 4 49 34 Education 137
32,76,14,15,137,educational phychology,Education,32 76 14 15 Education 137
28,19,42,48,137,educational phychology,Education,28 19 42 48 Education 137
5,76,9,47,137,educational phychology,Education,5 76 9 47 Education 137
6,28,84,19,137,educational phychology,Education,6 28 84 19 Education 137
3,47,17,70,137,educational phychology,Education,3 47 17 70 Education 137
39,75,7,16,137,educational phychology,Education,39 75 7 16 Education 137
29,35,32,41,137,educational phychology,Education,29 35 32 41 Education 137
50,69,8,10,137,educational phychology,Education,50 69 8 10 Education 137
0,9,41,87,137,educational phychology,Education,0 9 41 87 Education 137
62,52,6,17,137,educational phychology,Education,62 52 6 17 Education 137
0,3,56,78,137,educational phychology,Education,0 3 56 78 Education 137
12,4,82,39,137,educational phychology,Education,12 4 82 39 Education 137
25,27,17,68,137,educational phychology,Education,25 27 17 68 Education 137
55,0,15,67,137,educational phychology,Education,55 0 15 67 Education 137
44,93,0,0,137,educational phychology,Education,44 93 0 0 Education 137
36,21,13,67,137,educational phychology,Education,36 21 13 67 Education 137
27,29,28,53,137,educational phychology,Education,27 29 28 53 Education 137
65,36,25,11,137,educational phychology,Education,65 36 25 11 Education 137
78,25,29,5,137,educational phychology,Education,78 25 29 5 Education 137
15,35,47,41,138,educational phychology,Education,15 35 47 41 Education 138
0,17,84,37,138,educational phychology,Education,0 17 84 37 Education 138
10,39,8,81,138,educational phychology,Education,10 39 8 81 Education 138
58,38,16,26,138,educational phychology,Education,58 38 16 26 Education 138
9,55,35,39,138,educational phychology,Education,9 55 35 39 Education 138
2,70,22,44,138,educational phychology,Education,2 70 22 44 Education 138
52,9,7,70,138,educational phychology,Education,52 9 7 70 Education 138
67,40,18,13,138,educational phychology,Education,67 40 18 13 Education 138
7,40,4,87,138,educational phychology,Education,7 40 4 87 Education 138
35,21,8,74,138,educational phychology,Education,35 21 8 74 Education 138
18,43,47,30,138,educational phychology,Education,18 43 47 30 Education 138
45,65,9,19,138,educational phychology,Education,45 65 9 19 Education 138
38,29,35,36,138,educational phychology,Education,38 29 35 36 Education 138
23,35,26,54,138,educational phychology,Education,23 35 26 54 Education 138
43,55,17,23,138,educational phychology,Education,43 55 17 23 Education 138
51,41,43,3,138,educational phychology,Education,51 41 43 3 Education 138
42,28,33,35,138,educational phychology,Education,42 28 33 35 Education 138
87,34,14,3,138,educational phychology,Education,87 34 14 3 Education 138
90,6,35,7,138,educational phychology,Education,90 6 35 7 Education 138
23,41,31,43,138,educational phychology,Education,23 41 31 43 Education 138
15,20,25,78,138,educational phychology,Education,15 20 25 78 Education 138
86,2,12,38,138,educational phychology,Education,86 2 12 38 Education 138
53,30,32,23,138,educational phychology,Education,53 30 32 23 Education 138
50,51,24,13,138,educational phychology,Education,50 51 24 13 Education 138
58,27,42,11,138,educational phychology,Education,58 27 42 11 Education 138
4,94,1,39,138,educational phychology,Education,4 94 1 39 Education 138
84,11,22,22,139,educational phychology,Education,84 11 22 22 Education 139
23,0,70,46,139,educational phychology,Education,23 0 70 46 Education 139
43,14,61,21,139,educational phychology,Education,43 14 61 21 Education 139
34,46,10,49,139,educational phychology,Education,34 46 10 49 Education 139
46,15,26,52,139,educational phychology,Education,46 15 26 52 Education 139
63,50,8,18,139,educational phychology,Education,63 50 8 18 Education 139
28,10,20,81,139,educational phychology,Education,28 10 20 81 Education 139
22,50,16,51,139,educational phychology,Education,22 50 16 51 Education 139
68,42,19,10,139,educational phychology,Education,68 42 19 10 Education 139
78,2,9,50,139,educational phychology,Education,78 2 9 50 Education 139
21,99,19,0,139,educational phychology,Education,21 99 19 0 Education 139
89,15,20,15,139,educational phychology,Education,89 15 20 15 Education 139
63,17,39,20,139,educational phychology,Education,63 17 39 20 Education 139
84,0,24,31,139,educational phychology,Education,84 0 24 31 Education 139
20,51,36,32,139,educational phychology,Education,20 51 36 32 Education 139
7,51,57,24,139,educational phychology,Education,7 51 57 24 Education 139
11,2,57,69,139,educational phychology,Education,11 2 57 69 Education 139
40,12,27,60,139,educational phychology,Education,40 12 27 60 Education 139
71,0,48,20,139,educational phychology,Education,71 0 48 20 Education 139
7,22,52,58,139,educational phychology,Education,7 22 52 58 Education 139
39,5,1,94,139,educational phychology,Education,39 5 1 94 Education 139
6,41,18,74,139,educational phychology,Education,6 41 18 74 Education 139
0,39,10,90,139,educational phychology,Education,0 39 10 90 Education 139
25,29,45,40,139,educational phychology,Education,25 29 45 40 Education 139
0,28,27,84,139,educational phychology,Education,0 28 27 84 Education 139
65,50,13,11,139,educational phychology,Education,65 50 13 11 Education 139
52,14,42,31,139,educational phychology,Education,52 14 42 31 Education 139
55,29,14,42,140,educational phychology,Education,55 29 14 42 Education 140
38,26,6,70,140,educational phychology,Education,38 26 6 70 Education 140
29,6,83,22,140,educational phychology,Education,29 6 83 22 Education 140
44,32,27,37,140,educational phychology,Education,44 32 27 37 Education 140
50,14,8,68,140,educational phychology,Education,50 14 8 68 Education 140
48,55,15,22,140,educational phychology,Education,48 55 15 22 Education 140
31,63,35,11,140,educational phychology,Education,31 63 35 11 Education 140
24,15,55,46,140,educational phychology,Education,24 15 55 46 Education 140
14,58,42,26,140,educational phychology,Education,14 58 42 26 Education 140
14,65,56,5,140,educational phychology,Education,14 65 56 5 Education 140
13,6,37,84,140,educational phychology,Education,13 6 37 84 Education 140
52,8,24,56,140,educational phychology,Education,52 8 24 56 Education 140
14,30,85,11,140,educational phychology,Education,14 30 85 11 Education 140
40,8,3,89,140,educational phychology,Education,40 8 3 89 Education 140
48,20,44,28,140,educational phychology,Education,48 20 44 28 Education 140
58,66,8,8,140,educational phychology,Education,58 66 8 8 Education 140
20,4,36,80,140,educational phychology,Education,20 4 36 80 Education 140
5,74,5,56,140,educational phychology,Education,5 74 5 56 Education 140
25,69,19,27,140,educational phychology,Education,25 69 19 27 Education 140
77,2,14,47,140,educational phychology,Education,77 2 14 47 Education 140
57,4,27,52,140,educational phychology,Education,57 4 27 52 Education 140
5,25,98,12,140,educational phychology,Education,5 25 98 12 Education 140
37,89,5,9,140,educational phychology,Education,37 89 5 9 Education 140
91,3,45,1,140,educational phychology,Education,91 3 45 1 Education 140
11,64,21,44,140,educational phychology,Education,11 64 21 44 Education 140
50,47,35,8,140,educational phychology,Education,50 47 35 8 Education 140
10,11,23,96,140,educational phychology,Education,10 11 23 96 Education 140
49,73,6,12,140,educational phychology,Education,49 73 6 12 Education 140
71,50,10,9,140,educational phychology,Education,71 50 10 9 Education 140
50,31,44,15,140,educational phychology,Education,50 31 44 15 Education 140
59,50,12,19,140,educational phychology,Education,59 50 12 19 Education 140
87,13,1,39,140,educational phychology,Education,87 13 1 39 Education 140
4,35,6,96,141,records and archives managment,Education,4 35 6 96 Education 141
14,48,16,63,141,records and archives managment,Education,14 48 16 63 Education 141
19,38,11,73,141,records and archives managment,Education,19 38 11 73 Education 141
25,17,80,19,141,records and archives managment,Education,25 17 80 19 Education 141
7,24,15,95,141,records and archives managment,Education,7 24 15 95 Education 141
35,40,4,62,141,records and archives managment,Education,35 40 4 62 Education 141
38,62,29,12,141,records and archives managment,Education,38 62 29 12 Education 141
18,28,4,91,141,records and archives managment,Education,18 28 4 91 Education 141
20,47,58,16,141,records and archives managment,Education,20 47 58 16 Education 141
69,46,12,14,141,records and archives managment,Education,69 46 12 14 Education 141
84,0,28,29,141,records and archives managment,Education,84 0 28 29 Education 141
31,65,19,26,141,records and archives managment,Education,31 65 19 26 Education 141
6,69,10,56,141,records and archives managment,Education,6 69 10 56 Education 141
54,16,70,1,141,records and archives managment,Education,54 16 70 1 Education 141
42,23,21,55,141,records and archives managment,Education,42 23 21 55 Education 141
29,39,41,32,141,records and archives managment,Education,29 39 41 32 Education 141
55,9,4,73,141,records and archives managment,Education,55 9 4 73 Education 141
8,50,82,1,141,records and archives managment,Education,8 50 82 1 Education 141
75,23,3,40,141,records and archives managment,Education,75 23 3 40 Education 141
8,76,14,43,141,records and archives managment,Education,8 76 14 43 Education 141
68,50,10,13,141,records and archives managment,Education,68 50 10 13 Education 141
20,31,30,60,141,records and archives managment,Education,20 31 30 60 Education 141
16,68,14,43,141,records and archives managment,Education,16 68 14 43 Education 141
60,47,4,30,141,records and archives managment,Education,60 47 4 30 Education 141
80,31,8,22,141,records and archives managment,Education,80 31 8 22 Education 141
39,95,6,1,141,records and archives managment,Education,39 95 6 1 Education 141
52,46,21,22,141,records and archives managment,Education,52 46 21 22 Education 141
32,1,13,96,142,records and archives managment,Education,32 1 13 96 Education 142
16,50,21,55,142,records and archives managment,Education,16 50 21 55 Education 142
94,37,11,0,142,records and archives managment,Education,94 37 11 0 Education 142
22,9,89,22,142,records and archives managment,Education,22 9 89 22 Education 142
34,51,7,50,142,records and archives managment,Education,34 51 7 50 Education 142
14,46,1,81,142,records and archives managment,Education,14 46 1 81 Education 142
26,49,10,57,142,records and archives managment,Education,26 49 10 57 Education 142
77,3,51,11,142,records and archives managment,Education,77 3 51 11 Education 142
19,0,90,33,142,records and archives managment,Education,19 0 90 33 Education 142
36,6,19,81,142,records and archives managment,Education,36 6 19 81 Education 142
32,17,70,23,142,records and archives managment,Education,32 17 70 23 Education 142
18,47,58,19,142,records and archives managment,Education,18 47 58 19 Education 142
39,26,26,51,142,records and archives managment,Education,39 26 26 51 Education 142
8,40,30,64,142,records and archives managment,Education,8 40 30 64 Education 142
17,15,12,98,142,records and archives managment,Education,17 15 12 98 Education 142
11,81,20,30,142,records and archives managment,Education,11 81 20 30 Education 142
21,58,29,34,142,records and archives managment,Education,21 58 29 34 Education 142
17,59,37,29,142,records and archives managment,Education,17 59 37 29 Education 142
22,14,60,46,142,records and archives managment,Education,22 14 60 46 Education 142
4,15,47,76,142,records and archives managment,Education,4 15 47 76 Education 142
8,32,64,38,142,records and archives managment,Education,8 32 64 38 Education 142
46,37,9,50,142,records and archives managment,Education,46 37 9 50 Education 142
21,56,39,26,142,records and archives managment,Education,21 56 39 26 Education 142
13,20,53,56,142,records and archives managment,Education,13 20 53 56 Education 142
24,39,26,53,142,records and archives managment,Education,24 39 26 53 Education 142
36,79,1,26,142,records and archives managment,Education,36 79 1 26 Education 142
19,71,24,28,142,records and archives managment,Education,19 71 24 28 Education 142
28,36,0,78,142,records and archives managment,Education,28 36 0 78 Education 142
13,28,44,57,142,records and archives managment,Education,13 28 44 57 Education 142
11,29,36,66,142,records and archives managment,Education,11 29 36 66 Education 142
25,66,15,36,142,records and archives managment,Education,25 66 15 36 Education 142
29,88,6,19,142,records and archives managment,Education,29 88 6 19 Education 142
22,59,26,35,142,records and archives managment,Education,22 59 26 35 Education 142
49,35,14,44,142,records and archives managment,Education,49 35 14 44 Education 142
27,16,41,58,142,records and archives managment,Education,27 16 41 58 Education 142
25,68,11,38,142,records and archives managment,Education,25 68 11 38 Education 142
28,38,67,10,143,records and archives managment,Education,28 38 67 10 Education 143
36,52,1,54,143,records and archives managment,Education,36 52 1 54 Education 143
69,27,42,5,143,records and archives managment,Education,69 27 42 5 Education 143
20,35,38,50,143,records and archives managment,Education,20 35 38 50 Education 143
39,21,67,16,143,records and archives managment,Education,39 21 67 16 Education 143
99,13,22,9,143,records and archives managment,Education,99 13 22 9 Education 143
52,24,16,51,143,records and archives managment,Education,52 24 16 51 Education 143
16,46,39,42,143,records and archives managment,Education,16 46 39 42 Education 143
2,15,50,76,143,records and archives managment,Education,2 15 50 76 Education 143
59,48,14,22,143,records and archives managment,Education,59 48 14 22 Education 143
0,55,24,64,143,records and archives managment,Education,0 55 24 64 Education 143
17,15,23,88,143,records and archives managment,Education,17 15 23 88 Education 143
9,12,40,82,143,records and archives managment,Education,9 12 40 82 Education 143
42,25,6,70,143,records and archives managment,Education,42 25 6 70 Education 143
25,81,16,21,143,records and archives managment,Education,25 81 16 21 Education 143
8,38,35,62,143,records and archives managment,Education,8 38 35 62 Education 143
9,99,19,16,143,records and archives managment,Education,9 99 19 16 Education 143
37,81,14,11,143,records and archives managment,Education,37 81 14 11 Education 143
45,51,29,18,143,records and archives managment,Education,45 51 29 18 Education 143
86,17,40,0,143,records and archives managment,Education,86 17 40 0 Education 143
2,17,26,98,143,records and archives managment,Education,2 17 26 98 Education 143
50,9,6,78,143,records and archives managment,Education,50 9 6 78 Education 143
38,11,38,56,143,records and archives managment,Education,38 11 38 56 Education 143
58,12,15,59,144,records and archives managment,Education,58 12 15 59 Education 144
0,47,48,49,144,records and archives managment,Education,0 47 48 49 Education 144
94,4,37,9,144,records and archives managment,Education,94 4 37 9 Education 144
14,17,18,95,144,records and archives managment,Education,14 17 18 95 Education 144
100,9,35,0,144,records and archives managment,Education,100 9 35 0 Education 144
18,60,31,35,144,records and archives managment,Education,18 60 31 35 Education 144
32,14,43,55,144,records and archives managment,Education,32 14 43 55 Education 144
10,75,21,38,144,records and archives managment,Education,10 75 21 38 Education 144
21,35,33,55,144,records and archives managment,Education,21 35 33 55 Education 144
3,89,14,38,144,records and archives managment,Education,3 89 14 38 Education 144
8,7,69,60,144,records and archives managment,Education,8 7 69 60 Education 144
50,77,10,7,144,records and archives managment,Education,50 77 10 7 Education 144
36,67,29,12,144,records and archives managment,Education,36 67 29 12 Education 144
44,44,53,3,144,records and archives managment,Education,44 44 53 3 Education 144
9,63,49,23,144,records and archives managment,Education,9 63 49 23 Education 144
10,77,52,5,144,records and archives managment,Education,10 77 52 5 Education 144
23,44,34,43,144,records and archives managment,Education,23 44 34 43 Education 144
64,60,14,6,144,records and archives managment,Education,64 60 14 6 Education 144
39,61,6,38,144,records and archives managment,Education,39 61 6 38 Education 144
89,48,2,5,144,records and archives managment,Education,89 48 2 5 Education 144
69,70,3,2,144,records and archives managment,Education,69 70 3 2 Education 144
26,48,48,22,144,records and archives managment,Education,26 48 48 22 Education 144
11,99,7,27,144,records and archives managment,Education,11 99 7 27 Education 144
69,5,32,39,145,records and archives managment,Education,69 5 32 39 Education 145
28,53,13,51,145,records and archives managment,Education,28 53 13 51 Education 145
60,55,30,0,145,records and archives managment,Education,60 55 30 0 Education 145
31,50,63,1,145,records and archives managment,Education,31 50 63 1 Education 145
50,23,52,20,145,records and archives managment,Education,50 23 52 20 Education 145
50,55,14,26,145,records and archives managment,Education,50 55 14 26 Education 145
6,13,31,95,145,records and archives managment,Education,6 13 31 95 Education 145
9,9,50,77,145,records and archives managment,Education,9 9 50 77 Education 145
52,26,6,61,145,records and archives managment,Education,52 26 6 61 Education 145
18,6,58,63,145,records and archives managment,Education,18 6 58 63 Education 145
53,37,16,39,145,records and archives managment,Education,53 37 16 39 Education 145
0,2,57,86,145,records and archives managment,Education,0 2 57 86 Education 145
55,10,22,58,145,records and archives managment,Education,55 10 22 58 Education 145
39,45,53,8,145,records and archives managment,Education,39 45 53 8 Education 145
45,6,61,33,145,records and archives managment,Education,45 6 61 33 Education 145
78,2,65,0,145,records and archives managment,Education,78 2 65 0 Education 145
76,20,19,30,145,records and archives managment,Education,76 20 19 30 Education 145
32,88,19,6,145,records and archives managment,Education,32 88 19 6 Education 145
29,31,24,61,145,records and archives managment,Education,29 31 24 61 Education 145
8,38,22,77,145,records and archives managment,Education,8 38 22 77 Education 145
30,21,20,74,145,records and archives managment,Education,30 21 20 74 Education 145
33,12,24,76,145,records and archives managment,Education,33 12 24 76 Education 145
62,34,14,35,145,records and archives managment,Education,62 34 14 35 Education 145
5,28,49,63,145,records and archives managment,Education,5 28 49 63 Education 145
88,10,35,12,145,records and archives managment,Education,88 10 35 12 Education 145
50,20,3,72,145,records and archives managment,Education,50 20 3 72 Education 145
38,40,4,63,145,records and archives managment,Education,38 40 4 63 Education 145
79,35,21,10,145,records and archives managment,Education,79 35 21 10 Education 145
21,16,20,88,145,records and archives managment,Education,21 16 20 88 Education 145
69,18,34,24,145,records and archives managment,Education,69 18 34 24 Education 145
58,70,8,10,146,library and information studies,Education,58 70 8 10 Education 146
74,0,56,16,146,library and information studies,Education,74 0 56 16 Education 146
17,74,53,2,146,library and information studies,Education,17 74 53 2 Education 146
12,31,55,48,146,library and information studies,Education,12 31 55 48 Education 146
35,17,1,93,146,library and information studies,Education,35 17 1 93 Education 146
46,21,14,65,146,library and information studies,Education,46 21 14 65 Education 146
62,11,61,12,146,library and information studies,Education,62 11 61 12 Education 146
24,23,4,95,146,library and information studies,Education,24 23 4 95 Education 146
82,14,25,25,146,library and information studies,Education,82 14 25 25 Education 146
6,72,38,30,146,library and information studies,Education,6 72 38 30 Education 146
81,17,15,33,146,library and information studies,Education,81 17 15 33 Education 146
0,0,58,88,146,library and information studies,Education,0 0 58 88 Education 146
42,34,18,52,146,library and information studies,Education,42 34 18 52 Education 146
38,29,79,0,146,library and information studies,Education,38 29 79 0 Education 146
100,0,23,23,146,library and information studies,Education,100 0 23 23 Education 146
75,27,17,27,146,library and information studies,Education,75 27 17 27 Education 146
48,3,76,19,146,library and information studies,Education,48 3 76 19 Education 146
26,72,22,26,146,library and information studies,Education,26 72 22 26 Education 146
0,48,63,35,146,library and information studies,Education,0 48 63 35 Education 146
34,50,6,56,146,library and information studies,Education,34 50 6 56 Education 146
71,65,8,2,146,library and information studies,Education,71 65 8 2 Education 146
13,28,7,98,146,library and information studies,Education,13 28 7 98 Education 146
59,30,12,45,146,library and information studies,Education,59 30 12 45 Education 146
14,53,35,44,146,library and information studies,Education,14 53 35 44 Education 146
38,41,4,63,146,library and information studies,Education,38 41 4 63 Education 146
14,31,14,87,146,library and information studies,Education,14 31 14 87 Education 146
23,10,50,63,146,library and information studies,Education,23 10 50 63 Education 146
35,27,21,63,146,library and information studies,Education,35 27 21 63 Education 146
10,58,17,61,146,library and information studies,Education,10 58 17 61 Education 146
46,13,12,75,146,library and information studies,Education,46 13 12 75 Education 146
20,86,22,18,146,library and information studies,Education,20 86 22 18 Education 146
7,51,10,79,147,library and information studies,Education,7 51 10 79 Education 147
37,42,64,4,147,library and information studies,Education,37 42 64 4 Education 147
9,68,27,43,147,library and information studies,Education,9 68 27 43 Education 147
6,17,51,73,147,library and information studies,Education,6 17 51 73 Education 147
0,48,7,92,147,library and information studies,Education,0 48 7 92 Education 147
63,17,13,54,147,library and information studies,Education,63 17 13 54 Education 147
30,23,23,71,147,library and information studies,Education,30 23 23 71 Education 147
66,33,3,45,147,library and information studies,Education,66 33 3 45 Education 147
23,41,41,42,147,library and information studies,Education,23 41 41 42 Education 147
39,26,23,59,147,library and information studies,Education,39 26 23 59 Education 147
34,1,25,87,147,library and information studies,Education,34 1 25 87 Education 147
44,9,35,59,147,library and information studies,Education,44 9 35 59 Education 147
6,73,36,32,147,library and information studies,Education,6 73 36 32 Education 147
51,30,10,56,147,library and information studies,Education,51 30 10 56 Education 147
54,2,2,89,147,library and information studies,Education,54 2 2 89 Education 147
19,55,65,8,147,library and information studies,Education,19 55 65 8 Education 147
40,92,11,4,147,library and information studies,Education,40 92 11 4 Education 147
0,45,35,67,147,library and information studies,Education,0 45 35 67 Education 147
29,49,22,48,148,library and information studies,Education,29 49 22 48 Education 148
13,50,42,43,148,library and information studies,Education,13 50 42 43 Education 148
10,76,41,21,148,library and information studies,Education,10 76 41 21 Education 148
73,28,42,5,148,library and information studies,Education,73 28 42 5 Education 148
46,94,7,1,148,library and information studies,Education,46 94 7 1 Education 148
9,24,98,17,148,library and information studies,Education,9 24 98 17 Education 148
21,26,40,61,148,library and information studies,Education,21 26 40 61 Education 148
85,3,39,21,148,library and information studies,Education,85 3 39 21 Education 148
56,8,20,64,148,library and information studies,Education,56 8 20 64 Education 148
6,86,51,5,148,library and information studies,Education,6 86 51 5 Education 148
32,50,62,4,148,library and information studies,Education,32 50 62 4 Education 148
16,47,13,72,148,library and information studies,Education,16 47 13 72 Education 148
95,3,23,27,148,library and information studies,Education,95 3 23 27 Education 148
66,5,31,46,148,library and information studies,Education,66 5 31 46 Education 148
14,4,49,81,148,library and information studies,Education,14 4 49 81 Education 148
27,20,64,37,148,library and information studies,Education,27 20 64 37 Education 148
15,32,3,98,148,library and information studies,Education,15 32 3 98 Education 148
16,9,55,68,148,library and information studies,Education,16 9 55 68 Education 148
71,21,37,19,148,library and information studies,Education,71 21 37 19 Education 148
40,31,13,64,148,library and information studies,Education,40 31 13 64 Education 148
17,37,2,92,148,library and information studies,Education,17 37 2 92 Education 148
39,44,31,34,148,library and information studies,Education,39 44 31 34 Education 148
58,2,1,87,148,library and information studies,Education,58 2 1 87 Education 148
45,66,37,0,148,library and information studies,Education,45 66 37 0 Education 148
9,7,71,61,148,library and information studies,Education,9 7 71 61 Education 148
13,30,42,63,148,library and information studies,Education,13 30 42 63 Education 148
9,49,26,65,149,library and information studies,Education,9 49 26 65 Education 149
86,4,53,6,149,library and information studies,Education,86 4 53 6 Education 149
5,91,2,51,149,library and information studies,Education,5 91 2 51 Education 149
22,18,53,56,149,library and information studies,Education,22 18 53 56 Education 149
51,10,19,69,149,library and information studies,Education,51 10 19 69 Education 149
67,32,9,41,149,library and information studies,Education,67 32 9 41 Education 149
24,44,35,46,149,library and information studies,Education,24 44 35 46 Education 149
9,58,7,75,149,library and information studies,Education,9 58 7 75 Education 149
20,48,36,45,149,library and information studies,Education,20 48 36 45 Education 149
38,44,33,34,149,library and information studies,Education,38 44 33 34 Education 149
75,6,30,38,149,library and information studies,Education,75 6 30 38 Education 149
25,44,7,73,149,library and information studies,Education,25 44 7 73 Education 149
0,93,22,34,149,library and information studies,Education,0 93 22 34 Education 149
26,25,45,53,149,library and information studies,Education,26 25 45 53 Education 149
57,0,21,71,149,library and information studies,Education,57 0 21 71 Education 149
18,25,38,68,149,library and information studies,Education,18 25 38 68 Education 149
54,49,46,0,149,library and information studies,Education,54 49 46 0 Education 149
30,54,33,32,149,library and information studies,Education,30 54 33 32 Education 149
49,24,43,33,149,library and information studies,Education,49 24 43 33 Education 149
51,2,7,89,149,library and information studies,Education,51 2 7 89 Education 149
27,43,15,64,149,library and information studies,Education,27 43 15 64 Education 149
48,52,18,31,149,library and information studies,Education,48 52 18 31 Education 149
32,4,13,100,149,library and information studies,Education,32 4 13 100 Education 149
62,10,5,72,149,library and information studies,Education,62 10 5 72 Education 149
5,14,36,94,149,library and information studies,Education,5 14 36 94 Education 149
56,68,25,0,149,library and information studies,Education,56 68 25 0 Education 149
30,38,55,26,149,library and information studies,Education,30 38 55 26 Education 149
40,38,25,46,149,library and information studies,Education,40 38 25 46 Education 149
9,50,30,60,149,library and information studies,Education,9 50 30 60 Education 149
23,49,21,57,150,library and information studies,Education,23 49 21 57 Education 150
15,15,30,90,150,library and information studies,Education,15 15 30 90 Education 150
92,11,43,4,150,library and information studies,Education,92 11 43 4 Education 150
49,5,12,84,150,library and information studies,Education,49 5 12 84 Education 150
45,27,43,35,150,library and information studies,Education,45 27 43 35 Education 150
44,5,34,67,150,library and information studies,Education,44 5 34 67 Education 150
43,66,24,17,150,library and information studies,Education,43 66 24 17 Education 150
9,51,72,18,150,library and information studies,Education,9 51 72 18 Education 150
52,38,36,24,150,library and information studies,Education,52 38 36 24 Education 150
35,21,34,60,150,library and information studies,Education,35 21 34 60 Education 150
91,27,10,22,150,library and information studies,Education,91 27 10 22 Education 150
47,21,21,61,150,library and information studies,Education,47 21 21 61 Education 150
62,9,48,31,150,library and information studies,Education,62 9 48 31 Education 150
43,50,52,5,150,library and information studies,Education,43 50 52 5 Education 150
7,42,27,74,150,library and information studies,Education,7 42 27 74 Education 150
72,8,13,57,150,library and information studies,Education,72 8 13 57 Education 150
0,5,79,66,150,library and information studies,Education,0 5 79 66 Education 150
32,58,28,32,150,library and information studies,Education,32 58 28 32 Education 150
93,23,11,23,150,library and information studies,Education,93 23 11 23 Education 150
42,50,4,54,150,library and information studies,Education,42 50 4 54 Education 150
18,47,34,51,150,library and information studies,Education,18 47 34 51 Education 150
70,2,52,26,150,library and information studies,Education,70 2 52 26 Education 150
24,56,32,38,150,library and information studies,Education,24 56 32 38 Education 150
41,33,60,16,150,library and information studies,Education,41 33 60 16 Education 150
68,10,59,13,150,library and information studies,Education,68 10 59 13 Education 150
0,19,81,50,150,library and information studies,Education,0 19 81 50 Education 150
5,97,10,38,150,library and information studies,Education,5 97 10 38 Education 150
50,10,22,68,150,library and information studies,Education,50 10 22 68 Education 150
41,46,63,0,150,library and information studies,Education,41 46 63 0 Education 150
30,79,8,34,151,zambian cultures and ceremonies,Education,30 79 8 34 Education 151
58,53,19,21,151,zambian cultures and ceremonies,Education,58 53 19 21 Education 151
24,38,49,40,151,zambian cultures and ceremonies,Education,24 38 49 40 Education 151
19,18,61,53,151,zambian cultures and ceremonies,Education,19 18 61 53 Education 151
45,50,45,11,151,zambian cultures and ceremonies,Education,45 50 45 11 Education 151
0,11,73,67,151,zambian cultures and ceremonies,Education,0 11 73 67 Education 151
18,25,46,62,151,zambian cultures and ceremonies,Education,18 25 46 62 Education 151
59,24,10,58,151,zambian cultures and ceremonies,Education,59 24 10 58 Education 151
26,97,12,16,151,zambian cultures and ceremonies,Education,26 97 12 16 Education 151
22,40,28,61,151,zambian cultures and ceremonies,Education,22 40 28 61 Education 151
85,30,17,19,151,zambian cultures and ceremonies,Education,85 30 17 19 Education 151
2,2,86,61,151,zambian cultures and ceremonies,Education,2 2 86 61 Education 151
44,12,6,89,151,zambian cultures and ceremonies,Education,44 12 6 89 Education 151
33,66,42,10,151,zambian cultures and ceremonies,Education,33 66 42 10 Education 151
27,18,46,60,151,zambian cultures and ceremonies,Education,27 18 46 60 Education 151
40,67,24,20,151,zambian cultures and ceremonies,Education,40 67 24 20 Education 151
35,18,51,47,151,zambian cultures and ceremonies,Education,35 18 51 47 Education 151
11,6,81,53,151,zambian cultures and ceremonies,Education,11 6 81 53 Education 151
7,82,28,34,151,zambian cultures and ceremonies,Education,7 82 28 34 Education 151
6,61,21,63,151,zambian cultures and ceremonies,Education,6 61 21 63 Education 151
15,19,35,82,151,zambian cultures and ceremonies,Education,15 19 35 82 Education 151
24,3,26,98,151,zambian cultures and ceremonies,Education,24 3 26 98 Education 151
56,23,40,32,151,zambian cultures and ceremonies,Education,56 23 40 32 Education 151
63,18,42,28,151,zambian cultures and ceremonies,Education,63 18 42 28 Education 151
31,21,48,51,151,zambian cultures and ceremonies,Education,31 21 48 51 Education 151
36,68,44,3,151,zambian cultures and ceremonies,Education,36 68 44 3 Education 151
42,23,12,75,152,zambian cultures and ceremonies,Education,42 23 12 75 Education 152
50,9,28,65,152,zambian cultures and ceremonies,Education,50 9 28 65 Education 152
4,65,35,48,152,zambian cultures and ceremonies,Education,4 65 35 48 Education 152
50,12,73,17,152,zambian cultures and ceremonies,Education,50 12 73 17 Education 152
4,25,29,94,152,zambian cultures and ceremonies,Education,4 25 29 94 Education 152
15,14,32,91,152,zambian cultures and ceremonies,Education,15 14 32 91 Education 152
7,59,50,36,152,zambian cultures and ceremonies,Education,7 59 50 36 Education 152
11,55,35,51,152,zambian cultures and ceremonies,Education,11 55 35 51 Education 152
44,12,82,14,152,zambian cultures and ceremonies,Education,44 12 82 14 Education 152
33,51,4,64,152,zambian cultures and ceremonies,Education,33 51 4 64 Education 152
36,29,43,44,152,zambian cultures and ceremonies,Education,36 29 43 44 Education 152
22,51,24,55,152,zambian cultures and ceremonies,Education,22 51 24 55 Education 152
93,15,19,25,152,zambian cultures and ceremonies,Education,93 15 19 25 Education 152
19,2,50,81,152,zambian cultures and ceremonies,Education,19 2 50 81 Education 152
52,21,19,60,152,zambian cultures and ceremonies,Education,52 21 19 60 Education 152
37,82,9,25,153,zambian cultures and ceremonies,Education,37 82 9 25 Education 153
87,7,8,51,153,zambian cultures and ceremonies,Education,87 7 8 51 Education 153
17,10,70,56,153,zambian cultures and ceremonies,Education,17 10 70 56 Education 153
22,42,45,44,153,zambian cultures and ceremonies,Education,22 42 45 44 Education 153
3,32,75,43,153,zambian cultures and ceremonies,Education,3 32 75 43 Education 153
32,75,23,23,153,zambian cultures and ceremonies,Education,32 75 23 23 Education 153
41,57,24,31,153,zambian cultures and ceremonies,Education,41 57 24 31 Education 153
58,3,51,41,153,zambian cultures and ceremonies,Education,58 3 51 41 Education 153
22,40,48,43,153,zambian cultures and ceremonies,Education,22 40 48 43 Education 153
45,77,17,14,153,zambian cultures and ceremonies,Education,45 77 17 14 Education 153
99,4,42,8,153,zambian cultures and ceremonies,Education,99 4 42 8 Education 153
50,30,50,23,153,zambian cultures and ceremonies,Education,50 30 50 23 Education 153
27,68,29,29,153,zambian cultures and ceremonies,Education,27 68 29 29 Education 153
41,57,1,54,153,zambian cultures and ceremonies,Education,41 57 1 54 Education 153
12,33,59,49,153,zambian cultures and ceremonies,Education,12 33 59 49 Education 153
58,10,35,50,153,zambian cultures and ceremonies,Education,58 10 35 50 Education 153
32,0,72,49,153,zambian cultures and ceremonies,Education,32 0 72 49 Education 153
81,18,14,40,153,zambian cultures and ceremonies,Education,81 18 14 40 Education 153
50,47,3,53,153,zambian cultures and ceremonies,Education,50 47 3 53 Education 153
33,89,9,22,153,zambian cultures and ceremonies,Education,33 89 9 22 Education 153
33,74,30,16,153,zambian cultures and ceremonies,Education,33 74 30 16 Education 153
87,50,6,10,153,zambian cultures and ceremonies,Education,87 50 6 10 Education 153
40,56,26,31,153,zambian cultures and ceremonies,Education,40 56 26 31 Education 153
15,17,45,76,153,zambian cultures and ceremonies,Education,15 17 45 76 Education 153
42,87,13,11,153,zambian cultures and ceremonies,Education,42 87 13 11 Education 153
47,75,31,0,153,zambian cultures and ceremonies,Education,47 75 31 0 Education 153
18,78,8,49,153,zambian cultures and ceremonies,Education,18 78 8 49 Education 153
18,48,5,82,153,zambian cultures and ceremonies,Education,18 48 5 82 Education 153
1,34,84,34,153,zambian cultures and ceremonies,Education,1 34 84 34 Education 153
16,17,84,36,153,zambian cultures and ceremonies,Education,16 17 84 36 Education 153
60,6,7,81,154,zambian cultures and ceremonies,Education,60 6 7 81 Education 154
24,11,78,41,154,zambian cultures and ceremonies,Education,24 11 78 41 Education 154
17,78,29,30,154,zambian cultures and ceremonies,Education,17 78 29 30 Education 154
1,50,93,10,154,zambian cultures and ceremonies,Education,1 50 93 10 Education 154
66,14,46,28,154,zambian cultures and ceremonies,Education,66 14 46 28 Education 154
39,8,77,30,154,zambian cultures and ceremonies,Education,39 8 77 30 Education 154
44,5,22,83,154,zambian cultures and ceremonies,Education,44 5 22 83 Education 154
76,50,6,22,154,zambian cultures and ceremonies,Education,76 50 6 22 Education 154
22,78,14,40,154,zambian cultures and ceremonies,Education,22 78 14 40 Education 154
54,72,19,9,154,zambian cultures and ceremonies,Education,54 72 19 9 Education 154
61,48,27,18,154,zambian cultures and ceremonies,Education,61 48 27 18 Education 154
8,51,40,55,154,zambian cultures and ceremonies,Education,8 51 40 55 Education 154
70,76,5,3,154,zambian cultures and ceremonies,Education,70 76 5 3 Education 154
30,6,25,93,154,zambian cultures and ceremonies,Education,30 6 25 93 Education 154
26,53,44,31,154,zambian cultures and ceremonies,Education,26 53 44 31 Education 154
27,24,66,37,154,zambian cultures and ceremonies,Education,27 24 66 37 Education 154
27,12,39,76,154,zambian cultures and ceremonies,Education,27 12 39 76 Education 154
7,52,93,2,154,zambian cultures and ceremonies,Education,7 52 93 2 Education 154
47,15,80,12,154,zambian cultures and ceremonies,Education,47 15 80 12 Education 154
30,50,70,4,154,zambian cultures and ceremonies,Education,30 50 70 4 Education 154
16,48,48,42,154,zambian cultures and ceremonies,Education,16 48 48 42 Education 154
13,27,16,98,154,zambian cultures and ceremonies,Education,13 27 16 98 Education 154
9,91,48,6,154,zambian cultures and ceremonies,Education,9 91 48 6 Education 154
29,6,25,94,154,zambian cultures and ceremonies,Education,29 6 25 94 Education 154
68,10,11,65,154,zambian cultures and ceremonies,Education,68 10 11 65 Education 154
2,21,71,60,154,zambian cultures and ceremonies,Education,2 21 71 60 Education 154
22,55,33,44,154,zambian cultures and ceremonies,Education,22 55 33 44 Education 154
27,28,35,64,154,zambian cultures and ceremonies,Education,27 28 35 64 Education 154
50,22,1,81,154,zambian cultures and ceremonies,Education,50 22 1 81 Education 154
52,63,22,18,155,zambian cultures and ceremonies,Education,52 63 22 18 Education 155
0,43,72,40,155,zambian cultures and ceremonies,Education,0 43 72 40 Education 155
51,55,11,38,155,zambian cultures and ceremonies,Education,51 55 11 38 Education 155
2,52,5,96,155,zambian cultures and ceremonies,Education,2 52 5 96 Education 155
45,6,66,38,155,zambian cultures and ceremonies,Education,45 6 66 38 Education 155
37,46,23,49,155,zambian cultures and ceremonies,Education,37 46 23 49 Education 155
70,58,2,25,155,zambian cultures and ceremonies,Education,70 58 2 25 Education 155
54,23,27,51,155,zambian cultures and ceremonies,Education,54 23 27 51 Education 155
42,63,0,50,155,zambian cultures and ceremonies,Education,42 63 0 50 Education 155
59,26,15,55,155,zambian cultures and ceremonies,Education,59 26 15 55 Education 155
20,32,38,65,155,zambian cultures and ceremonies,Education,20 32 38 65 Education 155
67,24,35,29,155,zambian cultures and ceremonies,Education,67 24 35 29 Education 155
47,50,8,50,155,zambian cultures and ceremonies,Education,47 50 8 50 Education 155
0,56,95,4,155,zambian cultures and ceremonies,Education,0 56 95 4 Education 155
28,34,22,71,155,zambian cultures and ceremonies,Education,28 34 22 71 Education 155
23,20,32,80,155,zambian cultures and ceremonies,Education,23 20 32 80 Education 155
59,16,47,33,155,zambian cultures and ceremonies,Education,59 16 47 33 Education 155
59,12,21,63,155,zambian cultures and ceremonies,Education,59 12 21 63 Education 155
34,76,37,8,155,zambian cultures and ceremonies,Education,34 76 37 8 Education 155
91,16,30,18,155,zambian cultures and ceremonies,Education,91 16 30 18 Education 155
52,70,23,10,155,zambian cultures and ceremonies,Education,52 70 23 10 Education 155
9,64,18,64,155,zambian cultures and ceremonies,Education,9 64 18 64 Education 155
6,50,60,39,155,zambian cultures and ceremonies,Education,6 50 60 39 Education 155
40,50,64,1,155,zambian cultures and ceremonies,Education,40 50 64 1 Education 155
19,56,74,6,155,zambian cultures and ceremonies,Education,19 56 74 6 Education 155
75,5,51,24,155,zambian cultures and ceremonies,Education,75 5 51 24 Education 155
28,38,75,14,155,zambian cultures and ceremonies,Education,28 38 75 14 Education 155
46,61,46,3,156,education,Education,46 61 46 3 Education 156
90,12,36,18,156,education,Education,90 12 36 18 Education 156
56,72,8,20,156,education,Education,56 72 8 20 Education 156
17,33,12,94,156,education,Education,17 33 12 94 Education 156
62,11,17,66,156,education,Education,62 11 17 66 Education 156
47,43,45,21,156,education,Education,47 43 45 21 Education 156
11,28,90,27,156,education,Education,11 28 90 27 Education 156
19,48,47,42,156,education,Education,19 48 47 42 Education 156
57,15,76,8,156,education,Education,57 15 76 8 Education 156
30,78,17,31,156,education,Education,30 78 17 31 Education 156
5,13,44,94,156,education,Education,5 13 44 94 Education 156
10,77,1,68,156,education,Education,10 77 1 68 Education 156
2,56,5,93,156,education,Education,2 56 5 93 Education 156
22,60,19,55,156,education,Education,22 60 19 55 Education 156
25,35,17,79,156,education,Education,25 35 17 79 Education 156
75,55,11,15,156,education,Education,75 55 11 15 Education 156
70,18,49,19,156,education,Education,70 18 49 19 Education 156
19,52,55,30,156,education,Education,19 52 55 30 Education 156
0,24,52,80,156,education,Education,0 24 52 80 Education 156
17,95,24,20,156,education,Education,17 95 24 20 Education 156
0,59,6,92,157,education,Education,0 59 6 92 Education 157
39,81,18,19,157,education,Education,39 81 18 19 Education 157
0,65,2,90,157,education,Education,0 65 2 90 Education 157
24,38,36,59,157,education,Education,24 38 36 59 Education 157
27,61,28,41,157,education,Education,27 61 28 41 Education 157
25,36,11,85,157,education,Education,25 36 11 85 Education 157
67,73,9,8,157,education,Education,67 73 9 8 Education 157
30,13,61,53,157,education,Education,30 13 61 53 Education 157
22,6,40,89,157,education,Education,22 6 40 89 Education 157
71,6,27,53,157,education,Education,71 6 27 53 Education 157
0,1,73,83,157,education,Education,0 1 73 83 Education 157
58,51,31,17,157,education,Education,58 51 31 17 Education 157
32,39,3,83,157,education,Education,32 39 3 83 Education 157
72,8,12,65,157,education,Education,72 8 12 65 Education 157
24,57,33,43,157,education,Education,24 57 33 43 Education 157
100,4,13,40,157,education,Education,100 4 13 40 Education 157
31,21,32,73,157,education,Education,31 21 32 73 Education 157
70,8,58,21,157,education,Education,70 8 58 21 Education 157
71,19,29,38,157,education,Education,71 19 29 38 Education 157
9,49,18,81,157,education,Education,9 49 18 81 Education 157
33,37,29,58,157,education,Education,33 37 29 58 Education 157
10,34,49,64,157,education,Education,10 34 49 64 Education 157
100,6,13,38,157,education,Education,100 6 13 38 Education 157
92,52,2,11,157,education,Education,92 52 2 11 Education 157
29,51,30,47,157,education,Education,29 51 30 47 Education 157
40,19,44,54,157,education,Education,40 19 44 54 Education 157
25,54,42,36,157,education,Education,25 54 42 36 Education 157
9,50,18,80,157,education,Education,9 50 18 80 Education 157
20,41,90,6,157,education,Education,20 41 90 6 Education 157
73,46,37,1,157,education,Education,73 46 37 1 Education 157
3,42,16,96,157,education,Education,3 42 16 96 Education 157
65,62,13,17,157,education,Education,65 62 13 17 Education 157
51,64,32,10,157,education,Education,51 64 32 10 Education 157
7,52,31,67,157,education,Education,7 52 31 67 Education 157
32,18,45,62,157,education,Education,32 18 45 62 Education 157
8,98,2,49,157,education,Education,8 98 2 49 Education 157
6,44,86,21,157,education,Education,6 44 86 21 Education 157
23,34,62,38,157,education,Education,23 34 62 38 Education 157
73,50,17,18,158,education,Education,73 50 17 18 Education 158
10,40,41,67,158,education,Education,10 40 41 67 Education 158
84,10,2,62,158,education,Education,84 10 2 62 Education 158
60,15,10,73,158,education,Education,60 15 10 73 Education 158
9,47,41,61,158,education,Education,9 47 41 61 Education 158
4,68,61,25,158,education,Education,4 68 61 25 Education 158
28,87,7,36,158,education,Education,28 87 7 36 Education 158
19,49,42,48,158,education,Education,19 49 42 48 Education 158
45,93,13,7,158,education,Education,45 93 13 7 Education 158
33,40,39,46,158,education,Education,33 40 39 46 Education 158
10,69,24,55,158,education,Education,10 69 24 55 Education 158
22,3,81,52,158,education,Education,22 3 81 52 Education 158
80,8,53,17,158,education,Education,80 8 53 17 Education 158
45,70,8,35,158,education,Education,45 70 8 35 Education 158
87,9,2,60,158,education,Education,87 9 2 60 Education 158
50,9,42,57,158,education,Education,50 9 42 57 Education 158
37,29,5,87,158,education,Education,37 29 5 87 Education 158
54,7,39,58,158,education,Education,54 7 39 58 Education 158
63,9,50,36,158,education,Education,63 9 50 36 Education 158
46,50,50,12,158,education,Education,46 50 50 12 Education 158
66,35,28,29,158,education,Education,66 35 28 29 Education 158
33,38,82,5,158,education,Education,33 38 82 5 Education 158
76,38,27,18,159,education,Education,76 38 27 18 Education 159
37,61,27,34,159,education,Education,37 61 27 34 Education 159
33,84,15,27,159,education,Education,33 84 15 27 Education 159
91,19,16,33,159,education,Education,91 19 16 33 Education 159
40,55,62,2,159,education,Education,40 55 62 2 Education 159
73,54,23,9,159,education,Education,73 54 23 9 Education 159
83,50,24,2,159,education,Education,83 50 24 2 Education 159
18,46,63,32,159,education,Education,18 46 63 32 Education 159
6,60,37,56,159,education,Education,6 60 37 56 Education 159
28,49,37,45,159,education,Education,28 49 37 45 Education 159
25,50,44,40,159,education,Education,25 50 44 40 Education 159
52,9,48,50,159,education,Education,52 9 48 50 Education 159
3,33,28,95,159,education,Education,3 33 28 95 Education 159
14,41,15,89,159,education,Education,14 41 15 89 Education 159
21,79,41,18,159,education,Education,21 79 41 18 Education 159
2,13,84,60,159,education,Education,2 13 84 60 Education 159
80,4,65,10,159,education,Education,80 4 65 10 Education 159
71,40,32,16,159,education,Education,71 40 32 16 Education 159
45,53,35,26,159,education,Education,45 53 35 26 Education 159
48,86,1,24,159,education,Education,48 86 1 24 Education 159
19,23,37,80,159,education,Education,19 23 37 80 Education 159
67,66,7,19,159,education,Education,67 66 7 19 Education 159
31,5,23,100,159,education,Education,31 5 23 100 Education 159
29,77,22,31,159,education,Education,29 77 22 31 Education 159
60,18,45,36,159,education,Education,60 18 45 36 Education 159
44,55,30,30,159,education,Education,44 55 30 30 Education 159
68,29,40,22,159,education,Education,68 29 40 22 Education 159
1,26,59,73,159,education,Education,1 26 59 73 Education 159
44,49,44,22,159,education,Education,44 49 44 22 Education 159
61,50,14,34,159,education,Education,61 50 14 34 Education 159
36,8,49,66,159,education,Education,36 8 49 66 Education 159
31,31,65,32,159,education,Education,31 31 65 32 Education 159
13,75,69,2,159,education,Education,13 75 69 2 Education 159
24,23,66,46,159,education,Education,24 23 66 46 Education 159
56,12,21,70,159,education,Education,56 12 21 70 Education 159
17,44,45,54,160,education,Education,17 44 45 54 Education 160
22,98,14,26,160,education,Education,22 98 14 26 Education 160
43,11,20,86,160,education,Education,43 11 20 86 Education 160
1,82,55,22,160,education,Education,1 82 55 22 Education 160
25,32,24,79,160,education,Education,25 32 24 79 Education 160
19,47,56,38,160,education,Education,19 47 56 38 Education 160
38,50,68,4,160,education,Education,38 50 68 4 Education 160
4,50,54,52,160,education,Education,4 50 54 52 Education 160
23,33,56,48,160,education,Education,23 33 56 48 Education 160
69,16,25,50,160,education,Education,69 16 25 50 Education 160
73,11,21,55,160,education,Education,73 11 21 55 Education 160
42,25,45,48,160,education,Education,42 25 45 48 Education 160
2,60,43,55,160,education,Education,2 60 43 55 Education 160
97,22,17,24,160,education,Education,97 22 17 24 Education 160
28,79,8,45,160,education,Education,28 79 8 45 Education 160
14,70,56,20,160,education,Education,14 70 56 20 Education 160
36,23,39,62,160,education,Education,36 23 39 62 Education 160
24,30,74,32,160,education,Education,24 30 74 32 Education 160
23,25,66,46,160,education,Education,23 25 66 46 Education 160
50,30,21,59,160,education,Education,50 30 21 59 Education 160
95,5,29,31,160,education,Education,95 5 29 31 Education 160
9,32,92,27,160,education,Education,9 32 92 27 Education 160
0,60,50,50,160,education,Education,0 60 50 50 Education 160
24,72,14,50,160,education,Education,24 72 14 50 Education 160
48,56,0,57,161,agricultural science with education,Education,48 56 0 57 Education 161
82,36,16,27,161,agricultural science with education,Education,82 36 16 27 Education 161
77,19,52,13,161,agricultural science with education,Education,77 19 52 13 Education 161
13,54,46,48,161,agricultural science with education,Education,13 54 46 48 Education 161
0,29,92,40,161,agricultural science with education,Education,0 29 92 40 Education 161
58,17,18,68,161,agricultural science with education,Education,58 17 18 68 Education 161
46,61,19,35,161,agricultural science with education,Education,46 61 19 35 Education 161
44,59,33,25,161,agricultural science with education,Education,44 59 33 25 Education 161
72,23,17,49,161,agricultural science with education,Education,72 23 17 49 Education 161
42,95,17,7,161,agricultural science with education,Education,42 95 17 7 Education 161
61,66,4,30,161,agricultural science with education,Education,61 66 4 30 Education 161
54,47,34,26,161,agricultural science with education,Education,54 47 34 26 Education 161
38,22,19,82,161,agricultural science with education,Education,38 22 19 82 Education 161
34,38,84,5,161,agricultural science with education,Education,34 38 84 5 Education 161
58,15,8,80,161,agricultural science with education,Education,58 15 8 80 Education 161
53,29,46,33,161,agricultural science with education,Education,53 29 46 33 Education 161
62,64,13,22,161,agricultural science with education,Education,62 64 13 22 Education 161
41,75,32,13,161,agricultural science with education,Education,41 75 32 13 Education 161
54,3,10,94,161,agricultural science with education,Education,54 3 10 94 Education 161
39,14,17,91,161,agricultural science with education,Education,39 14 17 91 Education 161
3,65,75,18,161,agricultural science with education,Education,3 65 75 18 Education 161
50,28,50,33,161,agricultural science with education,Education,50 28 50 33 Education 161
97,18,27,19,161,agricultural science with education,Education,97 18 27 19 Education 161
4,83,3,71,161,agricultural science with education,Education,4 83 3 71 Education 161
21,33,24,83,161,agricultural science with education,Education,21 33 24 83 Education 161
17,11,50,83,161,agricultural science with education,Education,17 11 50 83 Education 161
39,13,99,10,161,agricultural science with education,Education,39 13 99 10 Education 161
41,38,23,59,161,agricultural science with education,Education,41 38 23 59 Education 161
22,81,24,34,161,agricultural science with education,Education,22 81 24 34 Education 161
21,92,7,41,161,agricultural science with education,Education,21 92 7 41 Education 161
77,35,39,10,161,agricultural science with education,Education,77 35 39 10 Education 161
47,42,29,43,161,agricultural science with education,Education,47 42 29 43 Education 161
21,33,15,92,161,agricultural science with education,Education,21 33 15 92 Education 161
67,70,3,21,161,agricultural science with education,Education,67 70 3 21 Education 161
46,6,33,76,161,agricultural science with education,Education,46 6 33 76 Education 161
60,39,33,30,162,agricultural science with education,Education,60 39 33 30 Education 162
57,8,73,24,162,agricultural science with education,Education,57 8 73 24 Education 162
42,30,65,25,162,agricultural science with education,Education,42 30 65 25 Education 162
86,21,26,29,162,agricultural science with education,Education,86 21 26 29 Education 162
69,69,11,13,162,agricultural science with education,Education,69 69 11 13 Education 162
92,17,43,10,162,agricultural science with education,Education,92 17 43 10 Education 162
91,63,8,0,162,agricultural science with education,Education,91 63 8 0 Education 162
40,28,35,59,162,agricultural science with education,Education,40 28 35 59 Education 162
37,64,45,16,162,agricultural science with education,Education,37 64 45 16 Education 162
52,11,74,25,162,agricultural science with education,Education,52 11 74 25 Education 162
10,29,31,92,162,agricultural science with education,Education,10 29 31 92 Education 162
36,67,17,42,162,agricultural science with education,Education,36 67 17 42 Education 162
17,68,27,50,162,agricultural science with education,Education,17 68 27 50 Education 162
14,64,43,41,162,agricultural science with education,Education,14 64 43 41 Education 162
13,65,51,33,162,agricultural science with education,Education,13 65 51 33 Education 162
37,31,33,61,162,agricultural science with education,Education,37 31 33 61 Education 162
21,48,55,38,162,agricultural science with education,Education,21 48 55 38 Education 162
38,65,29,30,162,agricultural science with education,Education,38 65 29 30 Education 162
51,33,6,72,162,agricultural science with education,Education,51 33 6 72 Education 162
74,49,5,34,162,agricultural science with education,Education,74 49 5 34 Education 162
22,56,34,50,162,agricultural science with education,Education,22 56 34 50 Education 162
7,25,65,65,162,agricultural science with education,Education,7 25 65 65 Education 162
96,8,5,53,162,agricultural science with education,Education,96 8 5 53 Education 162
17,62,55,28,162,agricultural science with education,Education,17 62 55 28 Education 162
46,32,23,61,162,agricultural science with education,Education,46 32 23 61 Education 162
42,72,14,34,162,agricultural science with education,Education,42 72 14 34 Education 162
7,64,39,52,162,agricultural science with education,Education,7 64 39 52 Education 162
26,50,70,16,162,agricultural science with education,Education,26 50 70 16 Education 162
36,11,73,42,162,agricultural science with education,Education,36 11 73 42 Education 162
6,72,3,81,162,agricultural science with education,Education,6 72 3 81 Education 162
30,56,36,40,162,agricultural science with education,Education,30 56 36 40 Education 162
20,82,10,50,162,agricultural science with education,Education,20 82 10 50 Education 162
34,3,82,44,163,agricultural science with education,Education,34 3 82 44 Education 163
48,3,34,78,163,agricultural science with education,Education,48 3 34 78 Education 163
21,97,45,0,163,agricultural science with education,Education,21 97 45 0 Education 163
18,69,31,45,163,agricultural science with education,Education,18 69 31 45 Education 163
42,14,14,93,163,agricultural science with education,Education,42 14 14 93 Education 163
56,72,14,21,163,agricultural science with education,Education,56 72 14 21 Education 163
45,52,45,21,163,agricultural science with education,Education,45 52 45 21 Education 163
48,14,5,96,163,agricultural science with education,Education,48 14 5 96 Education 163
88,20,43,12,163,agricultural science with education,Education,88 20 43 12 Education 163
19,44,37,63,163,agricultural science with education,Education,19 44 37 63 Education 163
43,82,18,20,163,agricultural science with education,Education,43 82 18 20 Education 163
41,34,50,38,163,agricultural science with education,Education,41 34 50 38 Education 163
21,6,62,74,163,agricultural science with education,Education,21 6 62 74 Education 163
81,10,1,71,163,agricultural science with education,Education,81 10 1 71 Education 163
68,3,55,37,163,agricultural science with education,Education,68 3 55 37 Education 163
12,35,58,58,163,agricultural science with education,Education,12 35 58 58 Education 163
0,71,5,87,163,agricultural science with education,Education,0 71 5 87 Education 163
45,2,84,32,163,agricultural science with education,Education,45 2 84 32 Education 163
15,39,81,28,163,agricultural science with education,Education,15 39 81 28 Education 163
20,74,44,25,163,agricultural science with education,Education,20 74 44 25 Education 163
92,25,38,8,163,agricultural science with education,Education,92 25 38 8 Education 163
27,19,49,68,163,agricultural science with education,Education,27 19 49 68 Education 163
49,40,42,32,163,agricultural science with education,Education,49 40 42 32 Education 163
45,16,7,95,163,agricultural science with education,Education,45 16 7 95 Education 163
14,35,15,99,163,agricultural science with education,Education,14 35 15 99 Education 163
62,18,73,10,163,agricultural science with education,Education,62 18 73 10 Education 163
47,87,12,17,163,agricultural science with education,Education,47 87 12 17 Education 163
53,2,95,13,163,agricultural science with education,Education,53 2 95 13 Education 163
32,91,16,24,163,agricultural science with education,Education,32 91 16 24 Education 163
11,91,0,61,163,agricultural science with education,Education,11 91 0 61 Education 163
77,41,6,39,163,agricultural science with education,Education,77 41 6 39 Education 163
10,84,8,61,163,agricultural science with education,Education,10 84 8 61 Education 163
55,64,18,27,164,agricultural science with education,Education,55 64 18 27 Education 164
18,64,48,34,164,agricultural science with education,Education,18 64 48 34 Education 164
45,49,29,41,164,agricultural science with education,Education,45 49 29 41 Education 164
0,30,97,37,164,agricultural science with education,Education,0 30 97 37 Education 164
50,50,60,4,164,agricultural science with education,Education,50 50 60 4 Education 164
29,47,42,46,164,agricultural science with education,Education,29 47 42 46 Education 164
31,91,26,16,164,agricultural science with education,Education,31 91 26 16 Education 164
17,18,43,86,164,agricultural science with education,Education,17 18 43 86 Education 164
27,42,17,78,164,agricultural science with education,Education,27 42 17 78 Education 164
46,50,18,50,164,agricultural science with education,Education,46 50 18 50 Education 164
16,36,45,67,164,agricultural science with education,Education,16 36 45 67 Education 164
0,71,6,87,164,agricultural science with education,Education,0 71 6 87 Education 164
40,41,32,51,164,agricultural science with education,Education,40 41 32 51 Education 164
58,58,36,12,164,agricultural science with education,Education,58 58 36 12 Education 164
44,9,41,70,164,agricultural science with education,Education,44 9 41 70 Education 164
3,45,38,78,164,agricultural science with education,Education,3 45 38 78 Education 164
42,46,20,56,164,agricultural science with education,Education,42 46 20 56 Education 164
31,91,18,24,164,agricultural science with education,Education,31 91 18 24 Education 164
79,72,5,8,164,agricultural science with education,Education,79 72 5 8 Education 164
64,50,41,9,164,agricultural science with education,Education,64 50 41 9 Education 164
23,12,62,67,164,agricultural science with education,Education,23 12 62 67 Education 164
27,25,41,71,164,agricultural science with education,Education,27 25 41 71 Education 164
91,0,8,65,164,agricultural science with education,Education,91 0 8 65 Education 164
40,78,20,26,164,agricultural science with education,Education,40 78 20 26 Education 164
23,29,54,58,164,agricultural science with education,Education,23 29 54 58 Education 164
84,19,54,7,164,agricultural science with education,Education,84 19 54 7 Education 164
32,23,36,73,164,agricultural science with education,Education,32 23 36 73 Education 164
49,26,66,23,164,agricultural science with education,Education,49 26 66 23 Education 164
33,53,2,76,164,agricultural science with education,Education,33 53 2 76 Education 164
33,20,36,75,164,agricultural science with education,Education,33 20 36 75 Education 164
14,27,47,76,164,agricultural science with education,Education,14 27 47 76 Education 164
8,72,83,1,164,agricultural science with education,Education,8 72 83 1 Education 164
14,45,42,63,164,agricultural science with education,Education,14 45 42 63 Education 164
50,9,9,96,164,agricultural science with education,Education,50 9 9 96 Education 164
32,74,38,21,165,agricultural science with education,Education,32 74 38 21 Education 165
46,42,42,35,165,agricultural science with education,Education,46 42 42 35 Education 165
28,77,33,27,165,agricultural science with education,Education,28 77 33 27 Education 165
16,58,31,60,165,agricultural science with education,Education,16 58 31 60 Education 165
99,2,29,35,165,agricultural science with education,Education,99 2 29 35 Education 165
10,37,99,19,165,agricultural science with education,Education,10 37 99 19 Education 165
63,96,4,2,165,agricultural science with education,Education,63 96 4 2 Education 165
0,81,2,82,165,agricultural science with education,Education,0 81 2 82 Education 165
3,75,53,34,165,agricultural science with education,Education,3 75 53 34 Education 165
24,47,27,67,165,agricultural science with education,Education,24 47 27 67 Education 165
63,21,5,76,165,agricultural science with education,Education,63 21 5 76 Education 165
46,12,97,10,165,agricultural science with education,Education,46 12 97 10 Education 165
45,33,15,72,165,agricultural science with education,Education,45 33 15 72 Education 165
33,50,77,5,165,agricultural science with education,Education,33 50 77 5 Education 165
26,8,76,55,165,agricultural science with education,Education,26 8 76 55 Education 165
27,34,30,74,165,agricultural science with education,Education,27 34 30 74 Education 165
46,37,37,45,165,agricultural science with education,Education,46 37 37 45 Education 165
50,31,43,41,165,agricultural science with education,Education,50 31 43 41 Education 165
15,59,44,47,165,agricultural science with education,Education,15 59 44 47 Education 165
14,50,33,68,165,agricultural science with education,Education,14 50 33 68 Education 165
31,34,81,19,165,agricultural science with education,Education,31 34 81 19 Education 165
32,80,5,48,165,agricultural science with education,Education,32 80 5 48 Education 165
34,50,12,69,165,agricultural science with education,Education,34 50 12 69 Education 165
32,31,31,71,165,agricultural science with education,Education,32 31 31 71 Education 165
5,49,86,25,165,agricultural science with education,Education,5 49 86 25 Education 165
50,51,39,25,165,agricultural science with education,Education,50 51 39 25 Education 165
95,7,4,59,165,agricultural science with education,Education,95 7 4 59 Education 165
22,13,56,75,166,adult education,Education,22 13 56 75 Education 166
40,98,22,6,166,adult education,Education,40 98 22 6 Education 166
75,11,44,36,166,adult education,Education,75 11 44 36 Education 166
94,26,45,1,166,adult education,Education,94 26 45 1 Education 166
8,96,17,45,166,adult education,Education,8 96 17 45 Education 166
50,36,7,73,166,adult education,Education,50 36 7 73 Education 166
62,83,6,15,166,adult education,Education,62 83 6 15 Education 166
14,57,34,61,166,adult education,Education,14 57 34 61 Education 166
43,100,13,10,166,adult education,Education,43 100 13 10 Education 166
24,54,26,62,166,adult education,Education,24 54 26 62 Education 166
82,26,40,18,166,adult education,Education,82 26 40 18 Education 166
19,46,56,45,166,adult education,Education,19 46 56 45 Education 166
41,92,11,22,166,adult education,Education,41 92 11 22 Education 166
65,18,0,83,166,adult education,Education,65 18 0 83 Education 166
87,71,3,5,166,adult education,Education,87 71 3 5 Education 166
23,43,55,45,166,adult education,Education,23 43 55 45 Education 166
51,43,17,55,166,adult education,Education,51 43 17 55 Education 166
22,73,33,38,166,adult education,Education,22 73 33 38 Education 166
8,88,6,64,166,adult education,Education,8 88 6 64 Education 166
8,91,2,65,166,adult education,Education,8 91 2 65 Education 166
72,50,1,43,166,adult education,Education,72 50 1 43 Education 166
49,91,21,5,166,adult education,Education,49 91 21 5 Education 166
80,8,33,45,166,adult education,Education,80 8 33 45 Education 166
58,40,56,12,166,adult education,Education,58 40 56 12 Education 166
32,47,24,63,166,adult education,Education,32 47 24 63 Education 166
21,37,15,94,167,adult education,Education,21 37 15 94 Education 167
15,56,35,61,167,adult education,Education,15 56 35 61 Education 167
3,69,4,91,167,adult education,Education,3 69 4 91 Education 167
59,19,35,54,167,adult education,Education,59 19 35 54 Education 167
18,25,40,84,167,adult education,Education,18 25 40 84 Education 167
74,61,26,6,167,adult education,Education,74 61 26 6 Education 167
69,50,28,20,167,adult education,Education,69 50 28 20 Education 167
15,81,23,48,167,adult education,Education,15 81 23 48 Education 167
29,44,45,49,167,adult education,Education,29 44 45 49 Education 167
63,79,4,21,167,adult education,Education,63 79 4 21 Education 167
2,1,88,76,167,adult education,Education,2 1 88 76 Education 167
98,4,61,4,167,adult education,Education,98 4 61 4 Education 167
20,80,28,39,167,adult education,Education,20 80 28 39 Education 167
18,37,92,20,167,adult education,Education,18 37 92 20 Education 167
50,61,3,53,167,adult education,Education,50 61 3 53 Education 167
80,38,26,23,167,adult education,Education,80 38 26 23 Education 167
72,69,10,16,167,adult education,Education,72 69 10 16 Education 167
0,81,44,42,167,adult education,Education,0 81 44 42 Education 167
35,54,21,57,167,adult education,Education,35 54 21 57 Education 167
38,62,26,41,167,adult education,Education,38 62 26 41 Education 167
65,4,11,87,167,adult education,Education,65 4 11 87 Education 167
55,98,3,11,167,adult education,Education,55 98 3 11 Education 167
50,3,25,89,167,adult education,Education,50 3 25 89 Education 167
66,53,29,19,167,adult education,Education,66 53 29 19 Education 167
83,0,58,26,167,adult education,Education,83 0 58 26 Education 167
8,57,56,46,167,adult education,Education,8 57 56 46 Education 167
47,7,86,27,167,adult education,Education,47 7 86 27 Education 167
80,0,65,22,167,adult education,Education,80 0 65 22 Education 167
49,24,68,26,167,adult education,Education,49 24 68 26 Education 167
16,66,25,60,167,adult education,Education,16 66 25 60 Education 167
35,65,39,28,167,adult education,Education,35 65 39 28 Education 167
9,90,43,25,167,adult education,Education,9 90 43 25 Education 167
83,32,33,19,167,adult education,Education,83 32 33 19 Education 167
70,62,29,6,167,adult education,Education,70 62 29 6 Education 167
20,50,93,4,167,adult education,Education,20 50 93 4 Education 167
53,11,16,87,167,adult education,Education,53 11 16 87 Education 167
29,43,24,71,167,adult education,Education,29 43 24 71 Education 167
4,32,99,32,167,adult education,Education,4 32 99 32 Education 167
62,21,54,30,167,adult education,Education,62 21 54 30 Education 167
34,44,48,41,167,adult education,Education,34 44 48 41 Education 167
26,10,36,95,167,adult education,Education,26 10 36 95 Education 167
39,21,18,89,167,adult education,Education,39 21 18 89 Education 167
40,3,25,99,167,adult education,Education,40 3 25 99 Education 167
37,32,41,57,167,adult education,Education,37 32 41 57 Education 167
11,100,27,30,168,adult education,Education,11 100 27 30 Education 168
15,63,52,38,168,adult education,Education,15 63 52 38 Education 168
0,68,10,90,168,adult education,Education,0 68 10 90 Education 168
20,47,95,6,168,adult education,Education,20 47 95 6 Education 168
5,39,46,78,168,adult education,Education,5 39 46 78 Education 168
51,14,53,50,168,adult education,Education,51 14 53 50 Education 168
33,67,54,14,168,adult education,Education,33 67 54 14 Education 168
12,58,38,60,168,adult education,Education,12 58 38 60 Education 168
28,38,51,51,168,adult education,Education,28 38 51 51 Education 168
20,21,29,98,168,adult education,Education,20 21 29 98 Education 168
4,79,7,78,168,adult education,Education,4 79 7 78 Education 168
23,52,30,63,168,adult education,Education,23 52 30 63 Education 168
46,56,16,50,168,adult education,Education,46 56 16 50 Education 168
11,88,59,10,168,adult education,Education,11 88 59 10 Education 168
18,44,50,56,168,adult education,Education,18 44 50 56 Education 168
2,49,29,88,168,adult education,Education,2 49 29 88 Education 168
96,63,8,1,168,adult education,Education,96 63 8 1 Education 168
75,5,44,44,168,adult education,Education,75 5 44 44 Education 168
68,86,3,11,168,adult education,Education,68 86 3 11 Education 168
72,69,14,13,168,adult education,Education,72 69 14 13 Education 168
37,38,25,68,168,adult education,Education,37 38 25 68 Education 168
44,75,12,37,168,adult education,Education,44 75 12 37 Education 168
0,0,74,94,168,adult education,Education,0 0 74 94 Education 168
11,72,1,84,168,adult education,Education,11 72 1 84 Education 168
80,6,39,43,168,adult education,Education,80 6 39 43 Education 168
63,65,10,30,168,adult education,Education,63 65 10 30 Education 168
17,63,22,66,168,adult education,Education,17 63 22 66 Education 168
65,47,31,25,168,adult education,Education,65 47 31 25 Education 168
50,43,73,3,169,adult education,Education,50 43 73 3 Education 169
21,48,23,77,169,adult education,Education,21 48 23 77 Education 169
65,74,12,18,169,adult education,Education,65 74 12 18 Education 169
60,30,17,62,169,adult education,Education,60 30 17 62 Education 169
32,49,71,17,169,adult education,Education,32 49 71 17 Education 169
65,50,19,35,169,adult education,Education,65 50 19 35 Education 169
16,74,36,43,169,adult education,Education,16 74 36 43 Education 169
22,51,43,53,169,adult education,Education,22 51 43 53 Education 169
53,45,32,39,169,adult education,Education,53 45 32 39 Education 169
67,78,9,15,169,adult education,Education,67 78 9 15 Education 169
3,91,1,74,169,adult education,Education,3 91 1 74 Education 169
10,100,12,47,169,adult education,Education,10 100 12 47 Education 169
46,19,26,78,169,adult education,Education,46 19 26 78 Education 169
12,44,39,74,169,adult education,Education,12 44 39 74 Education 169
50,12,12,95,169,adult education,Education,50 12 12 95 Education 169
46,15,62,46,169,adult education,Education,46 15 62 46 Education 169
70,16,21,62,169,adult education,Education,70 16 21 62 Education 169
34,50,74,11,169,adult education,Education,34 50 74 11 Education 169
9,43,21,96,169,adult education,Education,9 43 21 96 Education 169
40,47,17,65,169,adult education,Education,40 47 17 65 Education 169
20,31,59,59,169,adult education,Education,20 31 59 59 Education 169
74,54,13,28,169,adult education,Education,74 54 13 28 Education 169
50,27,46,46,169,adult education,Education,50 27 46 46 Education 169
8,25,95,41,169,adult education,Education,8 25 95 41 Education 169
5,100,4,60,169,adult education,Education,5 100 4 60 Education 169
71,6,67,25,169,adult education,Education,71 6 67 25 Education 169
57,50,5,57,169,adult education,Education,57 50 5 57 Education 169
86,1,41,42,170,adult education,Education,86 1 41 42 Education 170
23,49,81,17,170,adult education,Education,23 49 81 17 Education 170
27,60,35,48,170,adult education,Education,27 60 35 48 Education 170
38,16,32,84,170,adult education,Education,38 16 32 84 Education 170
68,15,17,70,170,adult education,Education,68 15 17 70 Education 170
57,17,39,57,170,adult education,Education,57 17 39 57 Education 170
65,93,7,5,170,adult education,Education,65 93 7 5 Education 170
50,56,20,44,170,adult education,Education,50 56 20 44 Education 170
67,7,10,86,170,adult education,Education,67 7 10 86 Education 170
47,15,96,12,170,adult education,Education,47 15 96 12 Education 170
49,48,4,69,170,adult education,Education,49 48 4 69 Education 170
72,19,65,14,170,adult education,Education,72 19 65 14 Education 170
94,68,5,3,170,adult education,Education,94 68 5 3 Education 170
49,74,45,2,170,adult education,Education,49 74 45 2 Education 170
68,5,21,76,170,adult education,Education,68 5 21 76 Education 170
28,30,79,33,170,adult education,Education,28 30 79 33 Education 170
61,43,27,39,170,adult education,Education,61 43 27 39 Education 170
48,20,22,80,170,adult education,Education,48 20 22 80 Education 170
55,28,87,0,170,adult education,Education,55 28 87 0 Education 170
22,61,41,46,170,adult education,Education,22 61 41 46 Education 170
65,7,70,28,170,adult education,Education,65 7 70 28 Education 170
8,34,33,95,170,adult education,Education,8 34 33 95 Education 170
96,50,11,13,170,adult education,Education,96 50 11 13 Education 170
46,80,17,27,170,adult education,Education,46 80 17 27 Education 170
49,91,12,18,170,adult education,Education,49 91 12 18 Education 170
11,45,22,92,170,adult education,Education,11 45 22 92 Education 170
69,40,25,36,170,adult education,Education,69 40 25 36 Education 170
75,22,57,16,170,adult education,Education,75 22 57 16 Education 170
28,52,41,49,170,adult education,Education,28 52 41 49 Education 170
5,88,1,76,170,adult education,Education,5 88 1 76 Education 170
12,63,53,42,170,adult education,Education,12 63 53 42 Education 170
72,24,61,13,170,adult education,Education,72 24 61 13 Education 170
33,37,28,73,171,enviromental and natural resources,Natural Sciences,33 37 28 73 Natural Sciences 171
27,32,59,53,171,enviromental and natural resources,Natural Sciences,27 32 59 53 Natural Sciences 171
66,23,4,78,171,enviromental and natural resources,Natural Sciences,66 23 4 78 Natural Sciences 171
20,48,56,47,171,enviromental and natural resources,Natural Sciences,20 48 56 47 Natural Sciences 171
81,13,64,13,171,enviromental and natural resources,Natural Sciences,81 13 64 13 Natural Sciences 171
71,2,55,43,171,enviromental and natural resources,Natural Sciences,71 2 55 43 Natural Sciences 171
21,86,62,2,171,enviromental and natural resources,Natural Sciences,21 86 62 2 Natural Sciences 171
50,42,7,72,171,enviromental and natural resources,Natural Sciences,50 42 7 72 Natural Sciences 171
62,1,42,66,171,enviromental and natural resources,Natural Sciences,62 1 42 66 Natural Sciences 171
52,39,34,46,171,enviromental and natural resources,Natural Sciences,52 39 34 46 Natural Sciences 171
90,4,4,73,171,enviromental and natural resources,Natural Sciences,90 4 4 73 Natural Sciences 171
28,71,41,31,171,enviromental and natural resources,Natural Sciences,28 71 41 31 Natural Sciences 171
15,56,56,44,171,enviromental and natural resources,Natural Sciences,15 56 56 44 Natural Sciences 171
42,62,39,28,171,enviromental and natural resources,Natural Sciences,42 62 39 28 Natural Sciences 171
19,60,79,13,171,enviromental and natural resources,Natural Sciences,19 60 79 13 Natural Sciences 171
44,32,35,60,171,enviromental and natural resources,Natural Sciences,44 32 35 60 Natural Sciences 171
30,19,26,96,171,enviromental and natural resources,Natural Sciences,30 19 26 96 Natural Sciences 171
63,6,21,81,171,enviromental and natural resources,Natural Sciences,63 6 21 81 Natural Sciences 171
72,39,14,46,171,enviromental and natural resources,Natural Sciences,72 39 14 46 Natural Sciences 171
50,29,72,20,171,enviromental and natural resources,Natural Sciences,50 29 72 20 Natural Sciences 171
80,12,45,34,171,enviromental and natural resources,Natural Sciences,80 12 45 34 Natural Sciences 171
44,32,63,32,171,enviromental and natural resources,Natural Sciences,44 32 63 32 Natural Sciences 171
44,65,54,8,171,enviromental and natural resources,Natural Sciences,44 65 54 8 Natural Sciences 171
46,57,38,30,171,enviromental and natural resources,Natural Sciences,46 57 38 30 Natural Sciences 171
52,53,32,34,171,enviromental and natural resources,Natural Sciences,52 53 32 34 Natural Sciences 171
96,7,68,0,171,enviromental and natural resources,Natural Sciences,96 7 68 0 Natural Sciences 171
47,60,48,16,171,enviromental and natural resources,Natural Sciences,47 60 48 16 Natural Sciences 171
12,50,75,34,171,enviromental and natural resources,Natural Sciences,12 50 75 34 Natural Sciences 171
41,38,69,23,171,enviromental and natural resources,Natural Sciences,41 38 69 23 Natural Sciences 171
74,17,22,58,171,enviromental and natural resources,Natural Sciences,74 17 22 58 Natural Sciences 171
34,32,49,56,171,enviromental and natural resources,Natural Sciences,34 32 49 56 Natural Sciences 171
29,79,15,48,171,enviromental and natural resources,Natural Sciences,29 79 15 48 Natural Sciences 171
61,45,44,21,171,enviromental and natural resources,Natural Sciences,61 45 44 21 Natural Sciences 171
85,13,48,25,171,enviromental and natural resources,Natural Sciences,85 13 48 25 Natural Sciences 171
38,55,21,57,171,enviromental and natural resources,Natural Sciences,38 55 21 57 Natural Sciences 171
65,22,2,82,171,enviromental and natural resources,Natural Sciences,65 22 2 82 Natural Sciences 171
11,12,58,90,171,enviromental and natural resources,Natural Sciences,11 12 58 90 Natural Sciences 171
53,66,33,19,171,enviromental and natural resources,Natural Sciences,53 66 33 19 Natural Sciences 171
49,10,53,60,172,enviromental and natural resources,Natural Sciences,49 10 53 60 Natural Sciences 172
20,0,84,68,172,enviromental and natural resources,Natural Sciences,20 0 84 68 Natural Sciences 172
58,5,18,91,172,enviromental and natural resources,Natural Sciences,58 5 18 91 Natural Sciences 172
57,13,13,89,172,enviromental and natural resources,Natural Sciences,57 13 13 89 Natural Sciences 172
18,43,47,64,172,enviromental and natural resources,Natural Sciences,18 43 47 64 Natural Sciences 172
53,5,40,74,172,enviromental and natural resources,Natural Sciences,53 5 40 74 Natural Sciences 172
72,20,46,34,172,enviromental and natural resources,Natural Sciences,72 20 46 34 Natural Sciences 172
22,47,77,26,172,enviromental and natural resources,Natural Sciences,22 47 77 26 Natural Sciences 172
19,89,36,28,172,enviromental and natural resources,Natural Sciences,19 89 36 28 Natural Sciences 172
18,40,27,87,172,enviromental and natural resources,Natural Sciences,18 40 27 87 Natural Sciences 172
46,19,99,8,172,enviromental and natural resources,Natural Sciences,46 19 99 8 Natural Sciences 172
28,20,48,76,172,enviromental and natural resources,Natural Sciences,28 20 48 76 Natural Sciences 172
92,9,46,25,172,enviromental and natural resources,Natural Sciences,92 9 46 25 Natural Sciences 172
63,36,70,3,172,enviromental and natural resources,Natural Sciences,63 36 70 3 Natural Sciences 172
19,57,41,55,172,enviromental and natural resources,Natural Sciences,19 57 41 55 Natural Sciences 172
25,21,70,56,172,enviromental and natural resources,Natural Sciences,25 21 70 56 Natural Sciences 172
18,31,64,59,172,enviromental and natural resources,Natural Sciences,18 31 64 59 Natural Sciences 172
43,66,17,46,172,enviromental and natural resources,Natural Sciences,43 66 17 46 Natural Sciences 172
14,70,24,64,172,enviromental and natural resources,Natural Sciences,14 70 24 64 Natural Sciences 172
26,30,45,71,172,enviromental and natural resources,Natural Sciences,26 30 45 71 Natural Sciences 172
55,83,10,24,172,enviromental and natural resources,Natural Sciences,55 83 10 24 Natural Sciences 172
12,49,31,80,172,enviromental and natural resources,Natural Sciences,12 49 31 80 Natural Sciences 172
82,33,15,42,172,enviromental and natural resources,Natural Sciences,82 33 15 42 Natural Sciences 172
0,87,73,12,172,enviromental and natural resources,Natural Sciences,0 87 73 12 Natural Sciences 172
23,74,36,39,172,enviromental and natural resources,Natural Sciences,23 74 36 39 Natural Sciences 172
12,67,16,77,172,enviromental and natural resources,Natural Sciences,12 67 16 77 Natural Sciences 172
30,5,56,81,172,enviromental and natural resources,Natural Sciences,30 5 56 81 Natural Sciences 172
26,71,69,6,172,enviromental and natural resources,Natural Sciences,26 71 69 6 Natural Sciences 172
32,65,34,41,172,enviromental and natural resources,Natural Sciences,32 65 34 41 Natural Sciences 172
57,0,18,97,172,enviromental and natural resources,Natural Sciences,57 0 18 97 Natural Sciences 172
52,51,33,36,172,enviromental and natural resources,Natural Sciences,52 51 33 36 Natural Sciences 172
16,51,54,51,172,enviromental and natural resources,Natural Sciences,16 51 54 51 Natural Sciences 172
32,25,77,38,172,enviromental and natural resources,Natural Sciences,32 25 77 38 Natural Sciences 172
31,23,40,78,172,enviromental and natural resources,Natural Sciences,31 23 40 78 Natural Sciences 172
60,46,35,31,172,enviromental and natural resources,Natural Sciences,60 46 35 31 Natural Sciences 172
70,7,34,61,172,enviromental and natural resources,Natural Sciences,70 7 34 61 Natural Sciences 172
47,11,21,93,172,enviromental and natural resources,Natural Sciences,47 11 21 93 Natural Sciences 172
40,25,40,67,172,enviromental and natural resources,Natural Sciences,40 25 40 67 Natural Sciences 172
98,16,46,12,172,enviromental and natural resources,Natural Sciences,98 16 46 12 Natural Sciences 172
27,59,61,25,172,enviromental and natural resources,Natural Sciences,27 59 61 25 Natural Sciences 172
55,56,1,60,172,enviromental and natural resources,Natural Sciences,55 56 1 60 Natural Sciences 172
30,60,42,40,172,enviromental and natural resources,Natural Sciences,30 60 42 40 Natural Sciences 172
95,21,21,36,173,enviromental and natural resources,Natural Sciences,95 21 21 36 Natural Sciences 173
60,15,92,6,173,enviromental and natural resources,Natural Sciences,60 15 92 6 Natural Sciences 173
55,22,23,73,173,enviromental and natural resources,Natural Sciences,55 22 23 73 Natural Sciences 173
26,66,24,57,173,enviromental and natural resources,Natural Sciences,26 66 24 57 Natural Sciences 173
51,22,21,79,173,enviromental and natural resources,Natural Sciences,51 22 21 79 Natural Sciences 173
0,91,76,6,173,enviromental and natural resources,Natural Sciences,0 91 76 6 Natural Sciences 173
64,56,45,8,173,enviromental and natural resources,Natural Sciences,64 56 45 8 Natural Sciences 173
66,50,31,26,173,enviromental and natural resources,Natural Sciences,66 50 31 26 Natural Sciences 173
73,26,28,46,173,enviromental and natural resources,Natural Sciences,73 26 28 46 Natural Sciences 173
28,61,47,37,173,enviromental and natural resources,Natural Sciences,28 61 47 37 Natural Sciences 173
72,15,72,14,173,enviromental and natural resources,Natural Sciences,72 15 72 14 Natural Sciences 173
15,50,29,79,173,enviromental and natural resources,Natural Sciences,15 50 29 79 Natural Sciences 173
10,75,58,30,173,enviromental and natural resources,Natural Sciences,10 75 58 30 Natural Sciences 173
0,9,90,74,173,enviromental and natural resources,Natural Sciences,0 9 90 74 Natural Sciences 173
16,21,83,53,173,enviromental and natural resources,Natural Sciences,16 21 83 53 Natural Sciences 173
6,67,18,82,173,enviromental and natural resources,Natural Sciences,6 67 18 82 Natural Sciences 173
19,33,33,88,173,enviromental and natural resources,Natural Sciences,19 33 33 88 Natural Sciences 173
42,30,24,77,173,enviromental and natural resources,Natural Sciences,42 30 24 77 Natural Sciences 173
43,31,59,40,173,enviromental and natural resources,Natural Sciences,43 31 59 40 Natural Sciences 173
9,39,61,64,173,enviromental and natural resources,Natural Sciences,9 39 61 64 Natural Sciences 173
75,6,14,78,173,enviromental and natural resources,Natural Sciences,75 6 14 78 Natural Sciences 173
42,24,39,68,173,enviromental and natural resources,Natural Sciences,42 24 39 68 Natural Sciences 173
71,50,35,17,173,enviromental and natural resources,Natural Sciences,71 50 35 17 Natural Sciences 173
53,24,75,21,173,enviromental and natural resources,Natural Sciences,53 24 75 21 Natural Sciences 173
2,58,55,58,173,enviromental and natural resources,Natural Sciences,2 58 55 58 Natural Sciences 173
85,50,19,19,173,enviromental and natural resources,Natural Sciences,85 50 19 19 Natural Sciences 173
6,82,40,45,173,enviromental and natural resources,Natural Sciences,6 82 40 45 Natural Sciences 173
5,92,13,63,173,enviromental and natural resources,Natural Sciences,5 92 13 63 Natural Sciences 173
22,36,50,65,173,enviromental and natural resources,Natural Sciences,22 36 50 65 Natural Sciences 173
34,38,22,79,173,enviromental and natural resources,Natural Sciences,34 38 22 79 Natural Sciences 173
45,23,80,26,174,enviromental and natural resources,Natural Sciences,45 23 80 26 Natural Sciences 174
71,82,10,11,174,enviromental and natural resources,Natural Sciences,71 82 10 11 Natural Sciences 174
61,50,47,16,174,enviromental and natural resources,Natural Sciences,61 50 47 16 Natural Sciences 174
90,9,30,45,174,enviromental and natural resources,Natural Sciences,90 9 30 45 Natural Sciences 174
13,86,32,43,174,enviromental and natural resources,Natural Sciences,13 86 32 43 Natural Sciences 174
29,41,80,24,174,enviromental and natural resources,Natural Sciences,29 41 80 24 Natural Sciences 174
44,30,11,89,174,enviromental and natural resources,Natural Sciences,44 30 11 89 Natural Sciences 174
13,75,72,14,174,enviromental and natural resources,Natural Sciences,13 75 72 14 Natural Sciences 174
27,79,16,52,174,enviromental and natural resources,Natural Sciences,27 79 16 52 Natural Sciences 174
46,56,30,42,174,enviromental and natural resources,Natural Sciences,46 56 30 42 Natural Sciences 174
18,95,22,39,174,enviromental and natural resources,Natural Sciences,18 95 22 39 Natural Sciences 174
35,41,66,32,174,enviromental and natural resources,Natural Sciences,35 41 66 32 Natural Sciences 174
14,50,33,77,174,enviromental and natural resources,Natural Sciences,14 50 33 77 Natural Sciences 174
52,72,39,11,174,enviromental and natural resources,Natural Sciences,52 72 39 11 Natural Sciences 174
94,5,11,64,174,enviromental and natural resources,Natural Sciences,94 5 11 64 Natural Sciences 174
91,22,20,41,174,enviromental and natural resources,Natural Sciences,91 22 20 41 Natural Sciences 174
59,44,22,49,174,enviromental and natural resources,Natural Sciences,59 44 22 49 Natural Sciences 174
53,56,29,36,174,enviromental and natural resources,Natural Sciences,53 56 29 36 Natural Sciences 174
7,33,44,90,174,enviromental and natural resources,Natural Sciences,7 33 44 90 Natural Sciences 174
92,14,54,14,174,enviromental and natural resources,Natural Sciences,92 14 54 14 Natural Sciences 174
9,100,11,54,174,enviromental and natural resources,Natural Sciences,9 100 11 54 Natural Sciences 174
10,37,50,77,174,enviromental and natural resources,Natural Sciences,10 37 50 77 Natural Sciences 174
41,54,56,23,174,enviromental and natural resources,Natural Sciences,41 54 56 23 Natural Sciences 174
62,24,45,43,174,enviromental and natural resources,Natural Sciences,62 24 45 43 Natural Sciences 174
85,13,57,19,174,enviromental and natural resources,Natural Sciences,85 13 57 19 Natural Sciences 174
18,41,20,95,174,enviromental and natural resources,Natural Sciences,18 41 20 95 Natural Sciences 174
56,17,26,75,174,enviromental and natural resources,Natural Sciences,56 17 26 75 Natural Sciences 174
0,62,46,66,174,enviromental and natural resources,Natural Sciences,0 62 46 66 Natural Sciences 174
50,45,39,40,174,enviromental and natural resources,Natural Sciences,50 45 39 40 Natural Sciences 174
22,47,87,18,174,enviromental and natural resources,Natural Sciences,22 47 87 18 Natural Sciences 174
35,65,28,46,174,enviromental and natural resources,Natural Sciences,35 65 28 46 Natural Sciences 174
59,15,50,50,174,enviromental and natural resources,Natural Sciences,59 15 50 50 Natural Sciences 174
16,14,46,99,175,enviromental and natural resources,Natural Sciences,16 14 46 99 Natural Sciences 175
97,62,8,8,175,enviromental and natural resources,Natural Sciences,97 62 8 8 Natural Sciences 175
50,61,64,0,175,enviromental and natural resources,Natural Sciences,50 61 64 0 Natural Sciences 175
72,43,26,34,175,enviromental and natural resources,Natural Sciences,72 43 26 34 Natural Sciences 175
88,5,45,37,175,enviromental and natural resources,Natural Sciences,88 5 45 37 Natural Sciences 175
35,30,80,30,175,enviromental and natural resources,Natural Sciences,35 30 80 30 Natural Sciences 175
19,57,76,23,175,enviromental and natural resources,Natural Sciences,19 57 76 23 Natural Sciences 175
24,31,42,78,175,enviromental and natural resources,Natural Sciences,24 31 42 78 Natural Sciences 175
4,50,54,67,175,enviromental and natural resources,Natural Sciences,4 50 54 67 Natural Sciences 175
33,46,22,74,175,enviromental and natural resources,Natural Sciences,33 46 22 74 Natural Sciences 175
41,37,58,39,175,enviromental and natural resources,Natural Sciences,41 37 58 39 Natural Sciences 175
28,56,43,48,175,enviromental and natural resources,Natural Sciences,28 56 43 48 Natural Sciences 175
36,10,54,75,175,enviromental and natural resources,Natural Sciences,36 10 54 75 Natural Sciences 175
15,67,84,9,175,enviromental and natural resources,Natural Sciences,15 67 84 9 Natural Sciences 175
77,50,14,34,175,enviromental and natural resources,Natural Sciences,77 50 14 34 Natural Sciences 175
57,95,14,9,175,enviromental and natural resources,Natural Sciences,57 95 14 9 Natural Sciences 175
19,40,60,56,175,enviromental and natural resources,Natural Sciences,19 40 60 56 Natural Sciences 175
43,67,42,23,175,enviromental and natural resources,Natural Sciences,43 67 42 23 Natural Sciences 175
76,4,87,8,175,enviromental and natural resources,Natural Sciences,76 4 87 8 Natural Sciences 175
86,16,11,62,175,enviromental and natural resources,Natural Sciences,86 16 11 62 Natural Sciences 175
6,74,5,90,175,enviromental and natural resources,Natural Sciences,6 74 5 90 Natural Sciences 175
51,50,11,63,175,enviromental and natural resources,Natural Sciences,51 50 11 63 Natural Sciences 175
10,15,52,98,175,enviromental and natural resources,Natural Sciences,10 15 52 98 Natural Sciences 175
50,16,50,59,175,enviromental and natural resources,Natural Sciences,50 16 50 59 Natural Sciences 175
25,56,73,21,175,enviromental and natural resources,Natural Sciences,25 56 73 21 Natural Sciences 175
79,20,58,18,175,enviromental and natural resources,Natural Sciences,79 20 58 18 Natural Sciences 175
10,15,60,90,175,enviromental and natural resources,Natural Sciences,10 15 60 90 Natural Sciences 175
26,77,31,41,175,enviromental and natural resources,Natural Sciences,26 77 31 41 Natural Sciences 175
12,13,70,80,175,enviromental and natural resources,Natural Sciences,12 13 70 80 Natural Sciences 175
81,50,28,16,175,enviromental and natural resources,Natural Sciences,81 50 28 16 Natural Sciences 175
30,50,52,43,175,enviromental and natural resources,Natural Sciences,30 50 52 43 Natural Sciences 175
8,20,97,51,176,ecology and wildlife management,Natural Sciences,8 20 97 51 Natural Sciences 176
11,68,46,51,176,ecology and wildlife management,Natural Sciences,11 68 46 51 Natural Sciences 176
42,64,43,27,176,ecology and wildlife management,Natural Sciences,42 64 43 27 Natural Sciences 176
20,66,1,89,176,ecology and wildlife management,Natural Sciences,20 66 1 89 Natural Sciences 176
18,61,37,60,176,ecology and wildlife management,Natural Sciences,18 61 37 60 Natural Sciences 176
53,36,77,10,176,ecology and wildlife management,Natural Sciences,53 36 77 10 Natural Sciences 176
0,79,5,92,176,ecology and wildlife management,Natural Sciences,0 79 5 92 Natural Sciences 176
20,72,31,53,176,ecology and wildlife management,Natural Sciences,20 72 31 53 Natural Sciences 176
35,12,34,95,176,ecology and wildlife management,Natural Sciences,35 12 34 95 Natural Sciences 176
30,45,41,60,176,ecology and wildlife management,Natural Sciences,30 45 41 60 Natural Sciences 176
50,20,8,98,176,ecology and wildlife management,Natural Sciences,50 20 8 98 Natural Sciences 176
65,60,21,30,176,ecology and wildlife management,Natural Sciences,65 60 21 30 Natural Sciences 176
6,84,14,72,176,ecology and wildlife management,Natural Sciences,6 84 14 72 Natural Sciences 176
54,44,34,44,176,ecology and wildlife management,Natural Sciences,54 44 34 44 Natural Sciences 176
27,62,29,58,176,ecology and wildlife management,Natural Sciences,27 62 29 58 Natural Sciences 176
44,45,54,33,176,ecology and wildlife management,Natural Sciences,44 45 54 33 Natural Sciences 176
85,13,30,48,176,ecology and wildlife management,Natural Sciences,85 13 30 48 Natural Sciences 176
61,49,4,62,176,ecology and wildlife management,Natural Sciences,61 49 4 62 Natural Sciences 176
48,50,78,0,176,ecology and wildlife management,Natural Sciences,48 50 78 0 Natural Sciences 176
91,14,66,5,176,ecology and wildlife management,Natural Sciences,91 14 66 5 Natural Sciences 176
36,86,3,51,176,ecology and wildlife management,Natural Sciences,36 86 3 51 Natural Sciences 176
11,15,64,86,176,ecology and wildlife management,Natural Sciences,11 15 64 86 Natural Sciences 176
58,64,30,24,176,ecology and wildlife management,Natural Sciences,58 64 30 24 Natural Sciences 176
33,37,71,35,176,ecology and wildlife management,Natural Sciences,33 37 71 35 Natural Sciences 176
5,75,96,0,176,ecology and wildlife management,Natural Sciences,5 75 96 0 Natural Sciences 176
15,41,51,69,176,ecology and wildlife management,Natural Sciences,15 41 51 69 Natural Sciences 176
48,73,32,23,176,ecology and wildlife management,Natural Sciences,48 73 32 23 Natural Sciences 176
13,62,29,72,176,ecology and wildlife management,Natural Sciences,13 62 29 72 Natural Sciences 176
26,33,70,47,176,ecology and wildlife management,Natural Sciences,26 33 70 47 Natural Sciences 176
26,54,93,3,176,ecology and wildlife management,Natural Sciences,26 54 93 3 Natural Sciences 176
14,38,57,67,176,ecology and wildlife management,Natural Sciences,14 38 57 67 Natural Sciences 176
61,65,34,16,176,ecology and wildlife management,Natural Sciences,61 65 34 16 Natural Sciences 176
55,50,69,2,176,ecology and wildlife management,Natural Sciences,55 50 69 2 Natural Sciences 176
84,16,69,7,176,ecology and wildlife management,Natural Sciences,84 16 69 7 Natural Sciences 176
17,66,91,3,177,ecology and wildlife management,Natural Sciences,17 66 91 3 Natural Sciences 177
42,42,55,38,177,ecology and wildlife management,Natural Sciences,42 42 55 38 Natural Sciences 177
30,11,67,69,177,ecology and wildlife management,Natural Sciences,30 11 67 69 Natural Sciences 177
47,87,19,24,177,ecology and wildlife management,Natural Sciences,47 87 19 24 Natural Sciences 177
53,34,87,3,177,ecology and wildlife management,Natural Sciences,53 34 87 3 Natural Sciences 177
8,46,57,66,177,ecology and wildlife management,Natural Sciences,8 46 57 66 Natural Sciences 177
50,41,1,85,177,ecology and wildlife management,Natural Sciences,50 41 1 85 Natural Sciences 177
66,25,31,55,177,ecology and wildlife management,Natural Sciences,66 25 31 55 Natural Sciences 177
27,75,33,42,177,ecology and wildlife management,Natural Sciences,27 75 33 42 Natural Sciences 177
38,60,48,31,177,ecology and wildlife management,Natural Sciences,38 60 48 31 Natural Sciences 177
76,29,42,30,177,ecology and wildlife management,Natural Sciences,76 29 42 30 Natural Sciences 177
10,16,53,98,177,ecology and wildlife management,Natural Sciences,10 16 53 98 Natural Sciences 177
17,17,93,50,177,ecology and wildlife management,Natural Sciences,17 17 93 50 Natural Sciences 177
37,64,35,41,177,ecology and wildlife management,Natural Sciences,37 64 35 41 Natural Sciences 177
20,43,53,61,177,ecology and wildlife management,Natural Sciences,20 43 53 61 Natural Sciences 177
5,54,53,65,177,ecology and wildlife management,Natural Sciences,5 54 53 65 Natural Sciences 177
39,42,44,52,177,ecology and wildlife management,Natural Sciences,39 42 44 52 Natural Sciences 177
9,21,53,94,177,ecology and wildlife management,Natural Sciences,9 21 53 94 Natural Sciences 177
26,36,52,63,177,ecology and wildlife management,Natural Sciences,26 36 52 63 Natural Sciences 177
40,52,55,30,177,ecology and wildlife management,Natural Sciences,40 52 55 30 Natural Sciences 177
42,21,38,76,177,ecology and wildlife management,Natural Sciences,42 21 38 76 Natural Sciences 177
20,73,51,33,177,ecology and wildlife management,Natural Sciences,20 73 51 33 Natural Sciences 177
36,45,42,54,177,ecology and wildlife management,Natural Sciences,36 45 42 54 Natural Sciences 177
94,33,30,20,177,ecology and wildlife management,Natural Sciences,94 33 30 20 Natural Sciences 177
11,29,57,80,177,ecology and wildlife management,Natural Sciences,11 29 57 80 Natural Sciences 177
34,74,48,21,177,ecology and wildlife management,Natural Sciences,34 74 48 21 Natural Sciences 177
20,11,64,82,177,ecology and wildlife management,Natural Sciences,20 11 64 82 Natural Sciences 177
42,51,42,43,178,ecology and wildlife management,Natural Sciences,42 51 42 43 Natural Sciences 178
77,26,52,23,178,ecology and wildlife management,Natural Sciences,77 26 52 23 Natural Sciences 178
30,80,54,14,178,ecology and wildlife management,Natural Sciences,30 80 54 14 Natural Sciences 178
6,91,0,81,178,ecology and wildlife management,Natural Sciences,6 91 0 81 Natural Sciences 178
50,37,61,30,178,ecology and wildlife management,Natural Sciences,50 37 61 30 Natural Sciences 178
38,27,23,90,178,ecology and wildlife management,Natural Sciences,38 27 23 90 Natural Sciences 178
63,48,45,22,178,ecology and wildlife management,Natural Sciences,63 48 45 22 Natural Sciences 178
56,17,71,34,178,ecology and wildlife management,Natural Sciences,56 17 71 34 Natural Sciences 178
34,22,47,75,178,ecology and wildlife management,Natural Sciences,34 22 47 75 Natural Sciences 178
41,98,19,20,178,ecology and wildlife management,Natural Sciences,41 98 19 20 Natural Sciences 178
27,89,25,37,178,ecology and wildlife management,Natural Sciences,27 89 25 37 Natural Sciences 178
41,27,50,60,178,ecology and wildlife management,Natural Sciences,41 27 50 60 Natural Sciences 178
24,50,95,9,178,ecology and wildlife management,Natural Sciences,24 50 95 9 Natural Sciences 178
38,51,56,33,178,ecology and wildlife management,Natural Sciences,38 51 56 33 Natural Sciences 178
23,73,31,51,178,ecology and wildlife management,Natural Sciences,23 73 31 51 Natural Sciences 178
81,49,46,2,178,ecology and wildlife management,Natural Sciences,81 49 46 2 Natural Sciences 178
8,78,26,66,178,ecology and wildlife management,Natural Sciences,8 78 26 66 Natural Sciences 178
51,57,56,14,178,ecology and wildlife management,Natural Sciences,51 57 56 14 Natural Sciences 178
14,73,29,62,178,ecology and wildlife management,Natural Sciences,14 73 29 62 Natural Sciences 178
30,82,47,19,178,ecology and wildlife management,Natural Sciences,30 82 47 19 Natural Sciences 178
61,58,32,27,178,ecology and wildlife management,Natural Sciences,61 58 32 27 Natural Sciences 178
6,42,73,57,178,ecology and wildlife management,Natural Sciences,6 42 73 57 Natural Sciences 178
64,68,42,4,178,ecology and wildlife management,Natural Sciences,64 68 42 4 Natural Sciences 178
12,56,47,63,178,ecology and wildlife management,Natural Sciences,12 56 47 63 Natural Sciences 178
59,21,8,90,178,ecology and wildlife management,Natural Sciences,59 21 8 90 Natural Sciences 178
91,18,18,51,178,ecology and wildlife management,Natural Sciences,91 18 18 51 Natural Sciences 178
78,12,12,76,178,ecology and wildlife management,Natural Sciences,78 12 12 76 Natural Sciences 178
10,60,85,23,178,ecology and wildlife management,Natural Sciences,10 60 85 23 Natural Sciences 178
28,36,50,64,178,ecology and wildlife management,Natural Sciences,28 36 50 64 Natural Sciences 178
25,66,65,22,178,ecology and wildlife management,Natural Sciences,25 66 65 22 Natural Sciences 178
53,64,55,6,178,ecology and wildlife management,Natural Sciences,53 64 55 6 Natural Sciences 178
32,18,67,61,178,ecology and wildlife management,Natural Sciences,32 18 67 61 Natural Sciences 178
46,38,34,60,178,ecology and wildlife management,Natural Sciences,46 38 34 60 Natural Sciences 178
4,98,22,54,178,ecology and wildlife management,Natural Sciences,4 98 22 54 Natural Sciences 178
96,16,2,64,178,ecology and wildlife management,Natural Sciences,96 16 2 64 Natural Sciences 178
45,20,68,45,178,ecology and wildlife management,Natural Sciences,45 20 68 45 Natural Sciences 178
18,26,38,96,178,ecology and wildlife management,Natural Sciences,18 26 38 96 Natural Sciences 178
90,55,15,18,178,ecology and wildlife management,Natural Sciences,90 55 15 18 Natural Sciences 178
14,92,57,16,179,ecology and wildlife management,Natural Sciences,14 92 57 16 Natural Sciences 179
14,19,95,51,179,ecology and wildlife management,Natural Sciences,14 19 95 51 Natural Sciences 179
34,69,32,44,179,ecology and wildlife management,Natural Sciences,34 69 32 44 Natural Sciences 179
61,60,24,34,179,ecology and wildlife management,Natural Sciences,61 60 24 34 Natural Sciences 179
21,70,59,29,179,ecology and wildlife management,Natural Sciences,21 70 59 29 Natural Sciences 179
69,16,25,69,179,ecology and wildlife management,Natural Sciences,69 16 25 69 Natural Sciences 179
61,62,31,25,179,ecology and wildlife management,Natural Sciences,61 62 31 25 Natural Sciences 179
58,90,5,26,179,ecology and wildlife management,Natural Sciences,58 90 5 26 Natural Sciences 179
73,85,7,14,179,ecology and wildlife management,Natural Sciences,73 85 7 14 Natural Sciences 179
87,69,4,19,179,ecology and wildlife management,Natural Sciences,87 69 4 19 Natural Sciences 179
30,51,43,55,179,ecology and wildlife management,Natural Sciences,30 51 43 55 Natural Sciences 179
37,51,12,79,179,ecology and wildlife management,Natural Sciences,37 51 12 79 Natural Sciences 179
41,24,47,67,179,ecology and wildlife management,Natural Sciences,41 24 47 67 Natural Sciences 179
61,1,81,36,179,ecology and wildlife management,Natural Sciences,61 1 81 36 Natural Sciences 179
83,1,16,79,179,ecology and wildlife management,Natural Sciences,83 1 16 79 Natural Sciences 179
86,36,25,32,179,ecology and wildlife management,Natural Sciences,86 36 25 32 Natural Sciences 179
56,40,53,30,179,ecology and wildlife management,Natural Sciences,56 40 53 30 Natural Sciences 179
51,15,36,77,179,ecology and wildlife management,Natural Sciences,51 15 36 77 Natural Sciences 179
54,9,48,68,179,ecology and wildlife management,Natural Sciences,54 9 48 68 Natural Sciences 179
30,52,15,82,179,ecology and wildlife management,Natural Sciences,30 52 15 82 Natural Sciences 179
39,4,67,69,179,ecology and wildlife management,Natural Sciences,39 4 67 69 Natural Sciences 179
44,43,76,16,179,ecology and wildlife management,Natural Sciences,44 43 76 16 Natural Sciences 179
0,1,97,81,179,ecology and wildlife management,Natural Sciences,0 1 97 81 Natural Sciences 179
24,25,95,35,179,ecology and wildlife management,Natural Sciences,24 25 95 35 Natural Sciences 179
80,5,20,74,179,ecology and wildlife management,Natural Sciences,80 5 20 74 Natural Sciences 179
62,1,31,85,179,ecology and wildlife management,Natural Sciences,62 1 31 85 Natural Sciences 179
38,37,36,68,179,ecology and wildlife management,Natural Sciences,38 37 36 68 Natural Sciences 179
30,39,53,58,180,ecology and wildlife management,Natural Sciences,30 39 53 58 Natural Sciences 180
75,79,23,3,180,ecology and wildlife management,Natural Sciences,75 79 23 3 Natural Sciences 180
74,10,95,1,180,ecology and wildlife management,Natural Sciences,74 10 95 1 Natural Sciences 180
35,46,35,64,180,ecology and wildlife management,Natural Sciences,35 46 35 64 Natural Sciences 180
90,5,78,7,180,ecology and wildlife management,Natural Sciences,90 5 78 7 Natural Sciences 180
24,76,44,36,180,ecology and wildlife management,Natural Sciences,24 76 44 36 Natural Sciences 180
55,67,18,40,180,ecology and wildlife management,Natural Sciences,55 67 18 40 Natural Sciences 180
70,21,4,85,180,ecology and wildlife management,Natural Sciences,70 21 4 85 Natural Sciences 180
25,44,22,89,180,ecology and wildlife management,Natural Sciences,25 44 22 89 Natural Sciences 180
17,27,51,85,180,ecology and wildlife management,Natural Sciences,17 27 51 85 Natural Sciences 180
61,29,16,74,180,ecology and wildlife management,Natural Sciences,61 29 16 74 Natural Sciences 180
43,22,85,30,180,ecology and wildlife management,Natural Sciences,43 22 85 30 Natural Sciences 180
92,70,12,6,180,ecology and wildlife management,Natural Sciences,92 70 12 6 Natural Sciences 180
0,6,97,77,180,ecology and wildlife management,Natural Sciences,0 6 97 77 Natural Sciences 180
10,6,87,77,180,ecology and wildlife management,Natural Sciences,10 6 87 77 Natural Sciences 180
50,68,0,62,180,ecology and wildlife management,Natural Sciences,50 68 0 62 Natural Sciences 180
51,16,16,97,180,ecology and wildlife management,Natural Sciences,51 16 16 97 Natural Sciences 180
12,51,95,22,180,ecology and wildlife management,Natural Sciences,12 51 95 22 Natural Sciences 180
40,83,11,46,180,ecology and wildlife management,Natural Sciences,40 83 11 46 Natural Sciences 180
13,50,89,28,180,ecology and wildlife management,Natural Sciences,13 50 89 28 Natural Sciences 180
65,97,4,14,180,ecology and wildlife management,Natural Sciences,65 97 4 14 Natural Sciences 180
61,15,15,89,180,ecology and wildlife management,Natural Sciences,61 15 15 89 Natural Sciences 180
68,50,37,25,180,ecology and wildlife management,Natural Sciences,68 50 37 25 Natural Sciences 180
13,83,70,14,180,ecology and wildlife management,Natural Sciences,13 83 70 14 Natural Sciences 180
94,20,61,5,180,ecology and wildlife management,Natural Sciences,94 20 61 5 Natural Sciences 180
28,63,38,51,180,ecology and wildlife management,Natural Sciences,28 63 38 51 Natural Sciences 180
83,30,34,33,180,ecology and wildlife management,Natural Sciences,83 30 34 33 Natural Sciences 180
71,11,43,55,180,ecology and wildlife management,Natural Sciences,71 11 43 55 Natural Sciences 180
50,50,49,31,180,ecology and wildlife management,Natural Sciences,50 50 49 31 Natural Sciences 180
93,75,10,2,180,ecology and wildlife management,Natural Sciences,93 75 10 2 Natural Sciences 180
72,34,4,70,180,ecology and wildlife management,Natural Sciences,72 34 4 70 Natural Sciences 180
14,71,10,85,180,ecology and wildlife management,Natural Sciences,14 71 10 85 Natural Sciences 180
53,39,27,61,180,ecology and wildlife management,Natural Sciences,53 39 27 61 Natural Sciences 180
34,76,41,29,180,ecology and wildlife management,Natural Sciences,34 76 41 29 Natural Sciences 180
27,77,26,50,180,ecology and wildlife management,Natural Sciences,27 77 26 50 Natural Sciences 180
77,72,24,7,180,ecology and wildlife management,Natural Sciences,77 72 24 7 Natural Sciences 180
45,93,32,10,180,ecology and wildlife management,Natural Sciences,45 93 32 10 Natural Sciences 180
15,84,8,73,180,ecology and wildlife management,Natural Sciences,15 84 8 73 Natural Sciences 180
13,66,93,8,180,ecology and wildlife management,Natural Sciences,13 66 93 8 Natural Sciences 180
49,34,51,47,181,foodscience and technology,Agricultural Sciences,49 34 51 47 Agricultural Sciences 181
50,40,47,44,181,foodscience and technology,Agricultural Sciences,50 40 47 44 Agricultural Sciences 181
37,43,64,37,181,foodscience and technology,Agricultural Sciences,37 43 64 37 Agricultural Sciences 181
52,32,30,67,181,foodscience and technology,Agricultural Sciences,52 32 30 67 Agricultural Sciences 181
80,15,35,51,181,foodscience and technology,Agricultural Sciences,80 15 35 51 Agricultural Sciences 181
9,87,37,48,181,foodscience and technology,Agricultural Sciences,9 87 37 48 Agricultural Sciences 181
12,61,56,52,181,foodscience and technology,Agricultural Sciences,12 61 56 52 Agricultural Sciences 181
98,3,63,17,181,foodscience and technology,Agricultural Sciences,98 3 63 17 Agricultural Sciences 181
16,38,57,70,181,foodscience and technology,Agricultural Sciences,16 38 57 70 Agricultural Sciences 181
55,22,29,75,181,foodscience and technology,Agricultural Sciences,55 22 29 75 Agricultural Sciences 181
20,50,86,25,181,foodscience and technology,Agricultural Sciences,20 50 86 25 Agricultural Sciences 181
55,74,23,29,181,foodscience and technology,Agricultural Sciences,55 74 23 29 Agricultural Sciences 181
67,39,3,72,181,foodscience and technology,Agricultural Sciences,67 39 3 72 Agricultural Sciences 181
47,37,63,34,181,foodscience and technology,Agricultural Sciences,47 37 63 34 Agricultural Sciences 181
56,71,20,34,181,foodscience and technology,Agricultural Sciences,56 71 20 34 Agricultural Sciences 181
17,42,51,71,181,foodscience and technology,Agricultural Sciences,17 42 51 71 Agricultural Sciences 181
17,25,43,96,181,foodscience and technology,Agricultural Sciences,17 25 43 96 Agricultural Sciences 181
20,60,51,50,181,foodscience and technology,Agricultural Sciences,20 60 51 50 Agricultural Sciences 181
20,35,43,83,181,foodscience and technology,Agricultural Sciences,20 35 43 83 Agricultural Sciences 181
18,56,43,64,181,foodscience and technology,Agricultural Sciences,18 56 43 64 Agricultural Sciences 181
64,76,33,8,181,foodscience and technology,Agricultural Sciences,64 76 33 8 Agricultural Sciences 181
59,2,94,26,181,foodscience and technology,Agricultural Sciences,59 2 94 26 Agricultural Sciences 181
25,35,71,50,181,foodscience and technology,Agricultural Sciences,25 35 71 50 Agricultural Sciences 181
57,11,59,54,181,foodscience and technology,Agricultural Sciences,57 11 59 54 Agricultural Sciences 181
43,38,52,48,181,foodscience and technology,Agricultural Sciences,43 38 52 48 Agricultural Sciences 181
0,86,4,91,181,foodscience and technology,Agricultural Sciences,0 86 4 91 Agricultural Sciences 181
88,6,11,76,181,foodscience and technology,Agricultural Sciences,88 6 11 76 Agricultural Sciences 181
63,50,47,21,181,foodscience and technology,Agricultural Sciences,63 50 47 21 Agricultural Sciences 181
94,15,25,47,181,foodscience and technology,Agricultural Sciences,94 15 25 47 Agricultural Sciences 181
19,93,28,41,181,foodscience and technology,Agricultural Sciences,19 93 28 41 Agricultural Sciences 181
50,33,88,10,181,foodscience and technology,Agricultural Sciences,50 33 88 10 Agricultural Sciences 181
29,45,16,91,181,foodscience and technology,Agricultural Sciences,29 45 16 91 Agricultural Sciences 181
44,45,11,81,181,foodscience and technology,Agricultural Sciences,44 45 11 81 Agricultural Sciences 181
11,62,38,70,181,foodscience and technology,Agricultural Sciences,11 62 38 70 Agricultural Sciences 181
51,19,18,93,181,foodscience and technology,Agricultural Sciences,51 19 18 93 Agricultural Sciences 181
33,37,30,81,181,foodscience and technology,Agricultural Sciences,33 37 30 81 Agricultural Sciences 181
59,43,30,49,181,foodscience and technology,Agricultural Sciences,59 43 30 49 Agricultural Sciences 181
15,63,13,90,181,foodscience and technology,Agricultural Sciences,15 63 13 90 Agricultural Sciences 181
48,23,28,83,182,foodscience and technology,Agricultural Sciences,48 23 28 83 Agricultural Sciences 182
3,89,13,77,182,foodscience and technology,Agricultural Sciences,3 89 13 77 Agricultural Sciences 182
36,39,37,70,182,foodscience and technology,Agricultural Sciences,36 39 37 70 Agricultural Sciences 182
66,49,63,4,182,foodscience and technology,Agricultural Sciences,66 49 63 4 Agricultural Sciences 182
70,6,41,65,182,foodscience and technology,Agricultural Sciences,70 6 41 65 Agricultural Sciences 182
9,79,37,57,182,foodscience and technology,Agricultural Sciences,9 79 37 57 Agricultural Sciences 182
62,61,20,39,182,foodscience and technology,Agricultural Sciences,62 61 20 39 Agricultural Sciences 182
51,49,46,36,182,foodscience and technology,Agricultural Sciences,51 49 46 36 Agricultural Sciences 182
33,57,22,70,182,foodscience and technology,Agricultural Sciences,33 57 22 70 Agricultural Sciences 182
36,87,26,33,182,foodscience and technology,Agricultural Sciences,36 87 26 33 Agricultural Sciences 182
63,89,27,3,182,foodscience and technology,Agricultural Sciences,63 89 27 3 Agricultural Sciences 182
61,9,57,55,182,foodscience and technology,Agricultural Sciences,61 9 57 55 Agricultural Sciences 182
68,20,9,85,182,foodscience and technology,Agricultural Sciences,68 20 9 85 Agricultural Sciences 182
29,14,68,71,182,foodscience and technology,Agricultural Sciences,29 14 68 71 Agricultural Sciences 182
43,20,27,92,182,foodscience and technology,Agricultural Sciences,43 20 27 92 Agricultural Sciences 182
0,85,7,90,182,foodscience and technology,Agricultural Sciences,0 85 7 90 Agricultural Sciences 182
32,52,95,3,182,foodscience and technology,Agricultural Sciences,32 52 95 3 Agricultural Sciences 182
22,59,72,29,182,foodscience and technology,Agricultural Sciences,22 59 72 29 Agricultural Sciences 182
38,84,23,37,182,foodscience and technology,Agricultural Sciences,38 84 23 37 Agricultural Sciences 182
42,70,27,43,182,foodscience and technology,Agricultural Sciences,42 70 27 43 Agricultural Sciences 182
54,8,29,91,182,foodscience and technology,Agricultural Sciences,54 8 29 91 Agricultural Sciences 182
43,66,60,13,182,foodscience and technology,Agricultural Sciences,43 66 60 13 Agricultural Sciences 182
82,43,44,13,182,foodscience and technology,Agricultural Sciences,82 43 44 13 Agricultural Sciences 182
98,12,59,13,182,foodscience and technology,Agricultural Sciences,98 12 59 13 Agricultural Sciences 182
7,18,65,92,182,foodscience and technology,Agricultural Sciences,7 18 65 92 Agricultural Sciences 182
8,50,55,69,182,foodscience and technology,Agricultural Sciences,8 50 55 69 Agricultural Sciences 182
31,86,57,8,182,foodscience and technology,Agricultural Sciences,31 86 57 8 Agricultural Sciences 182
85,8,55,35,183,foodscience and technology,Agricultural Sciences,85 8 55 35 Agricultural Sciences 183
42,90,25,26,183,foodscience and technology,Agricultural Sciences,42 90 25 26 Agricultural Sciences 183
20,85,32,46,183,foodscience and technology,Agricultural Sciences,20 85 32 46 Agricultural Sciences 183
7,78,46,52,183,foodscience and technology,Agricultural Sciences,7 78 46 52 Agricultural Sciences 183
36,27,60,60,183,foodscience and technology,Agricultural Sciences,36 27 60 60 Agricultural Sciences 183
84,16,45,38,183,foodscience and technology,Agricultural Sciences,84 16 45 38 Agricultural Sciences 183
53,33,95,2,183,foodscience and technology,Agricultural Sciences,53 33 95 2 Agricultural Sciences 183
6,10,69,98,183,foodscience and technology,Agricultural Sciences,6 10 69 98 Agricultural Sciences 183
50,16,28,89,183,foodscience and technology,Agricultural Sciences,50 16 28 89 Agricultural Sciences 183
42,7,49,85,183,foodscience and technology,Agricultural Sciences,42 7 49 85 Agricultural Sciences 183
11,3,100,69,183,foodscience and technology,Agricultural Sciences,11 3 100 69 Agricultural Sciences 183
77,6,36,64,183,foodscience and technology,Agricultural Sciences,77 6 36 64 Agricultural Sciences 183
10,80,89,4,183,foodscience and technology,Agricultural Sciences,10 80 89 4 Agricultural Sciences 183
11,72,11,89,183,foodscience and technology,Agricultural Sciences,11 72 11 89 Agricultural Sciences 183
57,24,66,36,183,foodscience and technology,Agricultural Sciences,57 24 66 36 Agricultural Sciences 183
63,21,34,65,183,foodscience and technology,Agricultural Sciences,63 21 34 65 Agricultural Sciences 183
38,31,28,86,183,foodscience and technology,Agricultural Sciences,38 31 28 86 Agricultural Sciences 183
25,92,49,17,183,foodscience and technology,Agricultural Sciences,25 92 49 17 Agricultural Sciences 183
27,61,17,78,183,foodscience and technology,Agricultural Sciences,27 61 17 78 Agricultural Sciences 183
59,73,43,8,183,foodscience and technology,Agricultural Sciences,59 73 43 8 Agricultural Sciences 183
49,26,54,54,183,foodscience and technology,Agricultural Sciences,49 26 54 54 Agricultural Sciences 183
34,95,31,23,183,foodscience and technology,Agricultural Sciences,34 95 31 23 Agricultural Sciences 183
21,50,90,22,183,foodscience and technology,Agricultural Sciences,21 50 90 22 Agricultural Sciences 183
84,93,2,4,183,foodscience and technology,Agricultural Sciences,84 93 2 4 Agricultural Sciences 183
30,79,35,39,183,foodscience and technology,Agricultural Sciences,30 79 35 39 Agricultural Sciences 183
97,5,59,22,183,foodscience and technology,Agricultural Sciences,97 5 59 22 Agricultural Sciences 183
21,48,58,56,183,foodscience and technology,Agricultural Sciences,21 48 58 56 Agricultural Sciences 183
96,19,25,43,183,foodscience and technology,Agricultural Sciences,96 19 25 43 Agricultural Sciences 183
21,62,92,8,183,foodscience and technology,Agricultural Sciences,21 62 92 8 Agricultural Sciences 183
67,50,60,6,183,foodscience and technology,Agricultural Sciences,67 50 60 6 Agricultural Sciences 183
34,89,17,43,183,foodscience and technology,Agricultural Sciences,34 89 17 43 Agricultural Sciences 183
22,5,64,92,183,foodscience and technology,Agricultural Sciences,22 5 64 92 Agricultural Sciences 183
100,20,31,32,183,foodscience and technology,Agricultural Sciences,100 20 31 32 Agricultural Sciences 183
65,25,24,69,183,foodscience and technology,Agricultural Sciences,65 25 24 69 Agricultural Sciences 183
96,51,24,12,183,foodscience and technology,Agricultural Sciences,96 51 24 12 Agricultural Sciences 183
67,73,15,28,183,foodscience and technology,Agricultural Sciences,67 73 15 28 Agricultural Sciences 183
97,9,23,54,183,foodscience and technology,Agricultural Sciences,97 9 23 54 Agricultural Sciences 183
58,5,44,76,183,foodscience and technology,Agricultural Sciences,58 5 44 76 Agricultural Sciences 183
85,9,66,23,183,foodscience and technology,Agricultural Sciences,85 9 66 23 Agricultural Sciences 183
74,6,85,18,183,foodscience and technology,Agricultural Sciences,74 6 85 18 Agricultural Sciences 183
56,6,50,71,183,foodscience and technology,Agricultural Sciences,56 6 50 71 Agricultural Sciences 183
24,30,70,59,183,foodscience and technology,Agricultural Sciences,24 30 70 59 Agricultural Sciences 183
41,35,37,70,183,foodscience and technology,Agricultural Sciences,41 35 37 70 Agricultural Sciences 183
12,82,35,55,184,foodscience and technology,Agricultural Sciences,12 82 35 55 Agricultural Sciences 184
11,79,15,79,184,foodscience and technology,Agricultural Sciences,11 79 15 79 Agricultural Sciences 184
28,70,46,40,184,foodscience and technology,Agricultural Sciences,28 70 46 40 Agricultural Sciences 184
31,31,37,85,184,foodscience and technology,Agricultural Sciences,31 31 37 85 Agricultural Sciences 184
21,84,64,15,184,foodscience and technology,Agricultural Sciences,21 84 64 15 Agricultural Sciences 184
29,75,43,37,184,foodscience and technology,Agricultural Sciences,29 75 43 37 Agricultural Sciences 184
43,1,50,90,184,foodscience and technology,Agricultural Sciences,43 1 50 90 Agricultural Sciences 184
92,10,36,46,184,foodscience and technology,Agricultural Sciences,92 10 36 46 Agricultural Sciences 184
17,69,34,64,184,foodscience and technology,Agricultural Sciences,17 69 34 64 Agricultural Sciences 184
39,67,29,49,184,foodscience and technology,Agricultural Sciences,39 67 29 49 Agricultural Sciences 184
91,24,22,47,184,foodscience and technology,Agricultural Sciences,91 24 22 47 Agricultural Sciences 184
43,16,83,42,184,foodscience and technology,Agricultural Sciences,43 16 83 42 Agricultural Sciences 184
16,45,89,34,184,foodscience and technology,Agricultural Sciences,16 45 89 34 Agricultural Sciences 184
32,85,37,30,184,foodscience and technology,Agricultural Sciences,32 85 37 30 Agricultural Sciences 184
1,91,63,29,184,foodscience and technology,Agricultural Sciences,1 91 63 29 Agricultural Sciences 184
95,87,2,0,184,foodscience and technology,Agricultural Sciences,95 87 2 0 Agricultural Sciences 184
77,14,48,45,184,foodscience and technology,Agricultural Sciences,77 14 48 45 Agricultural Sciences 184
59,59,52,14,184,foodscience and technology,Agricultural Sciences,59 59 52 14 Agricultural Sciences 184
68,51,14,51,184,foodscience and technology,Agricultural Sciences,68 51 14 51 Agricultural Sciences 184
25,36,47,76,184,foodscience and technology,Agricultural Sciences,25 36 47 76 Agricultural Sciences 184
0,0,100,84,184,foodscience and technology,Agricultural Sciences,0 0 100 84 Agricultural Sciences 184
8,58,95,23,184,foodscience and technology,Agricultural Sciences,8 58 95 23 Agricultural Sciences 184
6,59,26,93,184,foodscience and technology,Agricultural Sciences,6 59 26 93 Agricultural Sciences 184
95,38,16,35,184,foodscience and technology,Agricultural Sciences,95 38 16 35 Agricultural Sciences 184
19,38,61,66,184,foodscience and technology,Agricultural Sciences,19 38 61 66 Agricultural Sciences 184
72,58,20,34,184,foodscience and technology,Agricultural Sciences,72 58 20 34 Agricultural Sciences 184
83,50,42,9,184,foodscience and technology,Agricultural Sciences,83 50 42 9 Agricultural Sciences 184
50,86,3,45,184,foodscience and technology,Agricultural Sciences,50 86 3 45 Agricultural Sciences 184
23,9,70,82,184,foodscience and technology,Agricultural Sciences,23 9 70 82 Agricultural Sciences 184
45,33,28,78,184,foodscience and technology,Agricultural Sciences,45 33 28 78 Agricultural Sciences 184
61,15,67,41,184,foodscience and technology,Agricultural Sciences,61 15 67 41 Agricultural Sciences 184
9,87,13,75,184,foodscience and technology,Agricultural Sciences,9 87 13 75 Agricultural Sciences 184
28,81,10,65,184,foodscience and technology,Agricultural Sciences,28 81 10 65 Agricultural Sciences 184
36,50,44,54,184,foodscience and technology,Agricultural Sciences,36 50 44 54 Agricultural Sciences 184
47,35,57,45,184,foodscience and technology,Agricultural Sciences,47 35 57 45 Agricultural Sciences 184
23,44,53,64,184,foodscience and technology,Agricultural Sciences,23 44 53 64 Agricultural Sciences 184
31,42,71,40,184,foodscience and technology,Agricultural Sciences,31 42 71 40 Agricultural Sciences 184
59,40,57,29,185,foodscience and technology,Agricultural Sciences,59 40 57 29 Agricultural Sciences 185
93,24,26,42,185,foodscience and technology,Agricultural Sciences,93 24 26 42 Agricultural Sciences 185
52,5,55,73,185,foodscience and technology,Agricultural Sciences,52 5 55 73 Agricultural Sciences 185
97,16,68,4,185,foodscience and technology,Agricultural Sciences,97 16 68 4 Agricultural Sciences 185
39,90,21,35,185,foodscience and technology,Agricultural Sciences,39 90 21 35 Agricultural Sciences 185
7,85,19,74,185,foodscience and technology,Agricultural Sciences,7 85 19 74 Agricultural Sciences 185
82,91,12,0,185,foodscience and technology,Agricultural Sciences,82 91 12 0 Agricultural Sciences 185
26,57,37,65,185,foodscience and technology,Agricultural Sciences,26 57 37 65 Agricultural Sciences 185
34,73,68,10,185,foodscience and technology,Agricultural Sciences,34 73 68 10 Agricultural Sciences 185
45,83,43,14,185,foodscience and technology,Agricultural Sciences,45 83 43 14 Agricultural Sciences 185
90,33,35,27,185,foodscience and technology,Agricultural Sciences,90 33 35 27 Agricultural Sciences 185
56,36,22,71,185,foodscience and technology,Agricultural Sciences,56 36 22 71 Agricultural Sciences 185
30,39,59,57,185,foodscience and technology,Agricultural Sciences,30 39 59 57 Agricultural Sciences 185
37,40,65,43,185,foodscience and technology,Agricultural Sciences,37 40 65 43 Agricultural Sciences 185
8,66,30,81,185,foodscience and technology,Agricultural Sciences,8 66 30 81 Agricultural Sciences 185
58,27,14,86,185,foodscience and technology,Agricultural Sciences,58 27 14 86 Agricultural Sciences 185
26,79,21,59,185,foodscience and technology,Agricultural Sciences,26 79 21 59 Agricultural Sciences 185
55,79,31,20,185,foodscience and technology,Agricultural Sciences,55 79 31 20 Agricultural Sciences 185
77,26,5,77,185,foodscience and technology,Agricultural Sciences,77 26 5 77 Agricultural Sciences 185
4,97,14,70,185,foodscience and technology,Agricultural Sciences,4 97 14 70 Agricultural Sciences 185
76,85,23,1,185,foodscience and technology,Agricultural Sciences,76 85 23 1 Agricultural Sciences 185
19,64,29,73,185,foodscience and technology,Agricultural Sciences,19 64 29 73 Agricultural Sciences 185
81,28,35,41,185,foodscience and technology,Agricultural Sciences,81 28 35 41 Agricultural Sciences 185
47,72,44,22,185,foodscience and technology,Agricultural Sciences,47 72 44 22 Agricultural Sciences 185
10,90,81,4,185,foodscience and technology,Agricultural Sciences,10 90 81 4 Agricultural Sciences 185
74,71,14,26,185,foodscience and technology,Agricultural Sciences,74 71 14 26 Agricultural Sciences 185
31,34,40,80,185,foodscience and technology,Agricultural Sciences,31 34 40 80 Agricultural Sciences 185
27,32,54,72,185,foodscience and technology,Agricultural Sciences,27 32 54 72 Agricultural Sciences 185
17,75,89,4,185,foodscience and technology,Agricultural Sciences,17 75 89 4 Agricultural Sciences 185
28,40,42,75,185,foodscience and technology,Agricultural Sciences,28 40 42 75 Agricultural Sciences 185
2,58,79,46,185,foodscience and technology,Agricultural Sciences,2 58 79 46 Agricultural Sciences 185
22,63,35,65,185,foodscience and technology,Agricultural Sciences,22 63 35 65 Agricultural Sciences 185
32,73,53,27,185,foodscience and technology,Agricultural Sciences,32 73 53 27 Agricultural Sciences 185
51,50,77,7,185,foodscience and technology,Agricultural Sciences,51 50 77 7 Agricultural Sciences 185
50,50,23,62,185,foodscience and technology,Agricultural Sciences,50 50 23 62 Agricultural Sciences 185
38,58,29,60,185,foodscience and technology,Agricultural Sciences,38 58 29 60 Agricultural Sciences 185
14,55,57,59,185,foodscience and technology,Agricultural Sciences,14 55 57 59 Agricultural Sciences 185
67,31,14,73,185,foodscience and technology,Agricultural Sciences,67 31 14 73 Agricultural Sciences 185
59,3,68,55,185,foodscience and technology,Agricultural Sciences,59 3 68 55 Agricultural Sciences 185
8,84,16,77,185,foodscience and technology,Agricultural Sciences,8 84 16 77 Agricultural Sciences 185
28,40,62,56,186,enviromental health,Nursing Sciences,28 40 62 56 Nursing Sciences 186
21,64,44,57,186,enviromental health,Nursing Sciences,21 64 44 57 Nursing Sciences 186
45,49,63,29,186,enviromental health,Nursing Sciences,45 49 63 29 Nursing Sciences 186
47,60,11,68,186,enviromental health,Nursing Sciences,47 60 11 68 Nursing Sciences 186
22,71,41,52,186,enviromental health,Nursing Sciences,22 71 41 52 Nursing Sciences 186
4,44,95,43,186,enviromental health,Nursing Sciences,4 44 95 43 Nursing Sciences 186
49,39,36,62,186,enviromental health,Nursing Sciences,49 39 36 62 Nursing Sciences 186
34,43,64,45,186,enviromental health,Nursing Sciences,34 43 64 45 Nursing Sciences 186
56,21,71,38,186,enviromental health,Nursing Sciences,56 21 71 38 Nursing Sciences 186
66,27,67,26,186,enviromental health,Nursing Sciences,66 27 67 26 Nursing Sciences 186
70,8,10,98,186,enviromental health,Nursing Sciences,70 8 10 98 Nursing Sciences 186
69,60,17,40,186,enviromental health,Nursing Sciences,69 60 17 40 Nursing Sciences 186
63,50,17,56,186,enviromental health,Nursing Sciences,63 50 17 56 Nursing Sciences 186
10,76,7,93,186,enviromental health,Nursing Sciences,10 76 7 93 Nursing Sciences 186
94,17,58,17,186,enviromental health,Nursing Sciences,94 17 58 17 Nursing Sciences 186
53,23,89,21,186,enviromental health,Nursing Sciences,53 23 89 21 Nursing Sciences 186
57,14,52,63,186,enviromental health,Nursing Sciences,57 14 52 63 Nursing Sciences 186
78,77,13,18,186,enviromental health,Nursing Sciences,78 77 13 18 Nursing Sciences 186
35,48,5,98,186,enviromental health,Nursing Sciences,35 48 5 98 Nursing Sciences 186
89,35,47,15,186,enviromental health,Nursing Sciences,89 35 47 15 Nursing Sciences 186
46,78,29,33,186,enviromental health,Nursing Sciences,46 78 29 33 Nursing Sciences 186
23,79,55,29,186,enviromental health,Nursing Sciences,23 79 55 29 Nursing Sciences 186
29,50,56,51,186,enviromental health,Nursing Sciences,29 50 56 51 Nursing Sciences 186
81,10,81,14,186,enviromental health,Nursing Sciences,81 10 81 14 Nursing Sciences 186
87,10,26,63,186,enviromental health,Nursing Sciences,87 10 26 63 Nursing Sciences 186
59,28,27,72,186,enviromental health,Nursing Sciences,59 28 27 72 Nursing Sciences 186
80,26,62,18,186,enviromental health,Nursing Sciences,80 26 62 18 Nursing Sciences 186
54,40,54,38,186,enviromental health,Nursing Sciences,54 40 54 38 Nursing Sciences 186
64,50,42,30,186,enviromental health,Nursing Sciences,64 50 42 30 Nursing Sciences 186
75,35,11,65,186,enviromental health,Nursing Sciences,75 35 11 65 Nursing Sciences 186
13,56,38,79,186,enviromental health,Nursing Sciences,13 56 38 79 Nursing Sciences 186
86,7,83,10,186,enviromental health,Nursing Sciences,86 7 83 10 Nursing Sciences 186
73,9,47,57,186,enviromental health,Nursing Sciences,73 9 47 57 Nursing Sciences 186
44,8,54,80,186,enviromental health,Nursing Sciences,44 8 54 80 Nursing Sciences 186
2,80,25,79,186,enviromental health,Nursing Sciences,2 80 25 79 Nursing Sciences 186
4,98,16,68,186,enviromental health,Nursing Sciences,4 98 16 68 Nursing Sciences 186
10,38,67,71,186,enviromental health,Nursing Sciences,10 38 67 71 Nursing Sciences 186
50,22,40,74,186,enviromental health,Nursing Sciences,50 22 40 74 Nursing Sciences 186
76,10,93,7,186,enviromental health,Nursing Sciences,76 10 93 7 Nursing Sciences 186
16,47,85,39,187,enviromental health,Nursing Sciences,16 47 85 39 Nursing Sciences 187
50,97,21,19,187,enviromental health,Nursing Sciences,50 97 21 19 Nursing Sciences 187
48,44,26,69,187,enviromental health,Nursing Sciences,48 44 26 69 Nursing Sciences 187
1,22,89,75,187,enviromental health,Nursing Sciences,1 22 89 75 Nursing Sciences 187
30,52,40,65,187,enviromental health,Nursing Sciences,30 52 40 65 Nursing Sciences 187
94,16,38,39,187,enviromental health,Nursing Sciences,94 16 38 39 Nursing Sciences 187
22,80,7,78,187,enviromental health,Nursing Sciences,22 80 7 78 Nursing Sciences 187
53,16,78,40,187,enviromental health,Nursing Sciences,53 16 78 40 Nursing Sciences 187
16,49,37,85,187,enviromental health,Nursing Sciences,16 49 37 85 Nursing Sciences 187
61,29,55,42,187,enviromental health,Nursing Sciences,61 29 55 42 Nursing Sciences 187
95,4,57,31,187,enviromental health,Nursing Sciences,95 4 57 31 Nursing Sciences 187
86,8,82,11,187,enviromental health,Nursing Sciences,86 8 82 11 Nursing Sciences 187
40,38,88,21,187,enviromental health,Nursing Sciences,40 38 88 21 Nursing Sciences 187
39,59,60,29,187,enviromental health,Nursing Sciences,39 59 60 29 Nursing Sciences 187
13,49,90,35,187,enviromental health,Nursing Sciences,13 49 90 35 Nursing Sciences 187
24,19,89,55,187,enviromental health,Nursing Sciences,24 19 89 55 Nursing Sciences 187
79,23,69,16,187,enviromental health,Nursing Sciences,79 23 69 16 Nursing Sciences 187
50,62,57,18,187,enviromental health,Nursing Sciences,50 62 57 18 Nursing Sciences 187
68,61,29,29,187,enviromental health,Nursing Sciences,68 61 29 29 Nursing Sciences 187
84,53,25,25,187,enviromental health,Nursing Sciences,84 53 25 25 Nursing Sciences 187
50,68,7,62,187,enviromental health,Nursing Sciences,50 68 7 62 Nursing Sciences 187
62,51,30,44,187,enviromental health,Nursing Sciences,62 51 30 44 Nursing Sciences 187
25,60,92,10,187,enviromental health,Nursing Sciences,25 60 92 10 Nursing Sciences 187
56,19,44,68,187,enviromental health,Nursing Sciences,56 19 44 68 Nursing Sciences 187
45,81,33,28,187,enviromental health,Nursing Sciences,45 81 33 28 Nursing Sciences 187
27,64,26,70,187,enviromental health,Nursing Sciences,27 64 26 70 Nursing Sciences 187
77,18,55,37,187,enviromental health,Nursing Sciences,77 18 55 37 Nursing Sciences 187
98,8,69,12,187,enviromental health,Nursing Sciences,98 8 69 12 Nursing Sciences 187
32,91,54,10,187,enviromental health,Nursing Sciences,32 91 54 10 Nursing Sciences 187
26,84,38,39,187,enviromental health,Nursing Sciences,26 84 38 39 Nursing Sciences 187
48,41,24,74,187,enviromental health,Nursing Sciences,48 41 24 74 Nursing Sciences 187
68,54,37,28,187,enviromental health,Nursing Sciences,68 54 37 28 Nursing Sciences 187
14,53,63,57,187,enviromental health,Nursing Sciences,14 53 63 57 Nursing Sciences 187
82,91,6,8,187,enviromental health,Nursing Sciences,82 91 6 8 Nursing Sciences 187
36,36,44,71,187,enviromental health,Nursing Sciences,36 36 44 71 Nursing Sciences 187
65,10,94,18,187,enviromental health,Nursing Sciences,65 10 94 18 Nursing Sciences 187
48,26,36,77,187,enviromental health,Nursing Sciences,48 26 36 77 Nursing Sciences 187
21,46,57,63,187,enviromental health,Nursing Sciences,21 46 57 63 Nursing Sciences 187
32,74,28,53,187,enviromental health,Nursing Sciences,32 74 28 53 Nursing Sciences 187
22,87,38,40,187,enviromental health,Nursing Sciences,22 87 38 40 Nursing Sciences 187
40,23,55,70,188,enviromental health,Nursing Sciences,40 23 55 70 Nursing Sciences 188
37,83,19,49,188,enviromental health,Nursing Sciences,37 83 19 49 Nursing Sciences 188
19,41,81,47,188,enviromental health,Nursing Sciences,19 41 81 47 Nursing Sciences 188
71,95,9,13,188,enviromental health,Nursing Sciences,71 95 9 13 Nursing Sciences 188
57,13,32,86,188,enviromental health,Nursing Sciences,57 13 32 86 Nursing Sciences 188
98,45,34,11,188,enviromental health,Nursing Sciences,98 45 34 11 Nursing Sciences 188
57,75,48,8,188,enviromental health,Nursing Sciences,57 75 48 8 Nursing Sciences 188
36,37,20,95,188,enviromental health,Nursing Sciences,36 37 20 95 Nursing Sciences 188
25,18,66,79,188,enviromental health,Nursing Sciences,25 18 66 79 Nursing Sciences 188
56,22,55,55,188,enviromental health,Nursing Sciences,56 22 55 55 Nursing Sciences 188
17,26,66,79,188,enviromental health,Nursing Sciences,17 26 66 79 Nursing Sciences 188
93,10,26,59,188,enviromental health,Nursing Sciences,93 10 26 59 Nursing Sciences 188
86,23,47,32,188,enviromental health,Nursing Sciences,86 23 47 32 Nursing Sciences 188
78,67,12,31,188,enviromental health,Nursing Sciences,78 67 12 31 Nursing Sciences 188
47,61,36,44,188,enviromental health,Nursing Sciences,47 61 36 44 Nursing Sciences 188
26,12,57,93,188,enviromental health,Nursing Sciences,26 12 57 93 Nursing Sciences 188
39,79,1,69,188,enviromental health,Nursing Sciences,39 79 1 69 Nursing Sciences 188
94,31,22,41,188,enviromental health,Nursing Sciences,94 31 22 41 Nursing Sciences 188
85,27,36,40,188,enviromental health,Nursing Sciences,85 27 36 40 Nursing Sciences 188
62,20,24,82,188,enviromental health,Nursing Sciences,62 20 24 82 Nursing Sciences 188
59,14,59,56,188,enviromental health,Nursing Sciences,59 14 59 56 Nursing Sciences 188
45,19,63,61,188,enviromental health,Nursing Sciences,45 19 63 61 Nursing Sciences 188
29,98,34,27,188,enviromental health,Nursing Sciences,29 98 34 27 Nursing Sciences 188
41,50,11,86,188,enviromental health,Nursing Sciences,41 50 11 86 Nursing Sciences 188
28,69,33,58,188,enviromental health,Nursing Sciences,28 69 33 58 Nursing Sciences 188
85,57,38,8,188,enviromental health,Nursing Sciences,85 57 38 8 Nursing Sciences 188
2,99,7,80,188,enviromental health,Nursing Sciences,2 99 7 80 Nursing Sciences 188
43,13,46,86,188,enviromental health,Nursing Sciences,43 13 46 86 Nursing Sciences 188
35,88,19,46,188,enviromental health,Nursing Sciences,35 88 19 46 Nursing Sciences 188
44,63,39,42,188,enviromental health,Nursing Sciences,44 63 39 42 Nursing Sciences 188
0,36,85,67,188,enviromental health,Nursing Sciences,0 36 85 67 Nursing Sciences 188
67,17,77,27,188,enviromental health,Nursing Sciences,67 17 77 27 Nursing Sciences 188
67,51,19,52,189,enviromental health,Nursing Sciences,67 51 19 52 Nursing Sciences 189
11,81,88,9,189,enviromental health,Nursing Sciences,11 81 88 9 Nursing Sciences 189
6,97,3,83,189,enviromental health,Nursing Sciences,6 97 3 83 Nursing Sciences 189
8,26,94,61,189,enviromental health,Nursing Sciences,8 26 94 61 Nursing Sciences 189
46,74,25,44,189,enviromental health,Nursing Sciences,46 74 25 44 Nursing Sciences 189
9,66,23,91,189,enviromental health,Nursing Sciences,9 66 23 91 Nursing Sciences 189
51,25,56,57,189,enviromental health,Nursing Sciences,51 25 56 57 Nursing Sciences 189
55,59,75,0,189,enviromental health,Nursing Sciences,55 59 75 0 Nursing Sciences 189
95,36,23,35,189,enviromental health,Nursing Sciences,95 36 23 35 Nursing Sciences 189
9,83,85,12,189,enviromental health,Nursing Sciences,9 83 85 12 Nursing Sciences 189
7,69,44,69,189,enviromental health,Nursing Sciences,7 69 44 69 Nursing Sciences 189
51,89,12,37,189,enviromental health,Nursing Sciences,51 89 12 37 Nursing Sciences 189
39,85,64,1,189,enviromental health,Nursing Sciences,39 85 64 1 Nursing Sciences 189
36,85,14,54,189,enviromental health,Nursing Sciences,36 85 14 54 Nursing Sciences 189
23,69,65,32,189,enviromental health,Nursing Sciences,23 69 65 32 Nursing Sciences 189
73,34,0,82,189,enviromental health,Nursing Sciences,73 34 0 82 Nursing Sciences 189
15,87,47,40,189,enviromental health,Nursing Sciences,15 87 47 40 Nursing Sciences 189
32,19,55,83,189,enviromental health,Nursing Sciences,32 19 55 83 Nursing Sciences 189
59,50,53,27,189,enviromental health,Nursing Sciences,59 50 53 27 Nursing Sciences 189
68,18,50,53,189,enviromental health,Nursing Sciences,68 18 50 53 Nursing Sciences 189
40,34,48,67,189,enviromental health,Nursing Sciences,40 34 48 67 Nursing Sciences 189
23,88,14,64,189,enviromental health,Nursing Sciences,23 88 14 64 Nursing Sciences 189
88,30,5,66,189,enviromental health,Nursing Sciences,88 30 5 66 Nursing Sciences 189
31,16,92,50,189,enviromental health,Nursing Sciences,31 16 92 50 Nursing Sciences 189
26,81,66,16,189,enviromental health,Nursing Sciences,26 81 66 16 Nursing Sciences 189
28,80,56,25,189,enviromental health,Nursing Sciences,28 80 56 25 Nursing Sciences 189
34,59,56,40,189,enviromental health,Nursing Sciences,34 59 56 40 Nursing Sciences 189
25,50,56,58,189,enviromental health,Nursing Sciences,25 50 56 58 Nursing Sciences 189
45,11,50,83,189,enviromental health,Nursing Sciences,45 11 50 83 Nursing Sciences 189
64,23,14,88,189,enviromental health,Nursing Sciences,64 23 14 88 Nursing Sciences 189
28,13,53,95,189,enviromental health,Nursing Sciences,28 13 53 95 Nursing Sciences 189
0,90,53,46,189,enviromental health,Nursing Sciences,0 90 53 46 Nursing Sciences 189
97,57,13,22,189,enviromental health,Nursing Sciences,97 57 13 22 Nursing Sciences 189
43,48,42,56,189,enviromental health,Nursing Sciences,43 48 42 56 Nursing Sciences 189
8,56,97,28,189,enviromental health,Nursing Sciences,8 56 97 28 Nursing Sciences 189
85,16,60,28,189,enviromental health,Nursing Sciences,85 16 60 28 Nursing Sciences 189
80,20,37,52,189,enviromental health,Nursing Sciences,80 20 37 52 Nursing Sciences 189
35,98,28,28,189,enviromental health,Nursing Sciences,35 98 28 28 Nursing Sciences 189
66,14,42,67,189,enviromental health,Nursing Sciences,66 14 42 67 Nursing Sciences 189
88,42,52,7,189,enviromental health,Nursing Sciences,88 42 52 7 Nursing Sciences 189
98,41,30,20,189,enviromental health,Nursing Sciences,98 41 30 20 Nursing Sciences 189
69,68,22,31,190,enviromental health,Nursing Sciences,69 68 22 31 Nursing Sciences 190
58,29,54,49,190,enviromental health,Nursing Sciences,58 29 54 49 Nursing Sciences 190
34,14,75,67,190,enviromental health,Nursing Sciences,34 14 75 67 Nursing Sciences 190
98,9,82,1,190,enviromental health,Nursing Sciences,98 9 82 1 Nursing Sciences 190
90,2,92,6,190,enviromental health,Nursing Sciences,90 2 92 6 Nursing Sciences 190
17,73,42,58,190,enviromental health,Nursing Sciences,17 73 42 58 Nursing Sciences 190
64,61,37,28,190,enviromental health,Nursing Sciences,64 61 37 28 Nursing Sciences 190
19,94,16,61,190,enviromental health,Nursing Sciences,19 94 16 61 Nursing Sciences 190
46,50,54,40,190,enviromental health,Nursing Sciences,46 50 54 40 Nursing Sciences 190
63,26,40,61,190,enviromental health,Nursing Sciences,63 26 40 61 Nursing Sciences 190
79,2,87,22,190,enviromental health,Nursing Sciences,79 2 87 22 Nursing Sciences 190
14,26,54,96,190,enviromental health,Nursing Sciences,14 26 54 96 Nursing Sciences 190
61,14,52,63,190,enviromental health,Nursing Sciences,61 14 52 63 Nursing Sciences 190
12,41,43,94,190,enviromental health,Nursing Sciences,12 41 43 94 Nursing Sciences 190
18,45,28,99,190,enviromental health,Nursing Sciences,18 45 28 99 Nursing Sciences 190
29,65,28,68,190,enviromental health,Nursing Sciences,29 65 28 68 Nursing Sciences 190
60,9,27,94,190,enviromental health,Nursing Sciences,60 9 27 94 Nursing Sciences 190
36,13,48,93,190,enviromental health,Nursing Sciences,36 13 48 93 Nursing Sciences 190
72,12,53,53,190,enviromental health,Nursing Sciences,72 12 53 53 Nursing Sciences 190
32,22,95,41,190,enviromental health,Nursing Sciences,32 22 95 41 Nursing Sciences 190
73,11,23,83,190,enviromental health,Nursing Sciences,73 11 23 83 Nursing Sciences 190
58,9,24,99,190,enviromental health,Nursing Sciences,58 9 24 99 Nursing Sciences 190
7,17,69,97,190,enviromental health,Nursing Sciences,7 17 69 97 Nursing Sciences 190
78,17,48,47,190,enviromental health,Nursing Sciences,78 17 48 47 Nursing Sciences 190
48,45,63,34,190,enviromental health,Nursing Sciences,48 45 63 34 Nursing Sciences 190
78,50,53,9,190,enviromental health,Nursing Sciences,78 50 53 9 Nursing Sciences 190
89,4,3,94,190,enviromental health,Nursing Sciences,89 4 3 94 Nursing Sciences 190
33,78,26,53,190,enviromental health,Nursing Sciences,33 78 26 53 Nursing Sciences 190
85,18,41,46,190,enviromental health,Nursing Sciences,85 18 41 46 Nursing Sciences 190
31,66,74,19,190,enviromental health,Nursing Sciences,31 66 74 19 Nursing Sciences 190
13,73,69,35,190,enviromental health,Nursing Sciences,13 73 69 35 Nursing Sciences 190
87,11,63,30,191,parasitology,Natural Sciences,87 11 63 30 Natural Sciences 191
61,86,11,33,191,parasitology,Natural Sciences,61 86 11 33 Natural Sciences 191
19,61,54,57,191,parasitology,Natural Sciences,19 61 54 57 Natural Sciences 191
36,66,54,35,191,parasitology,Natural Sciences,36 66 54 35 Natural Sciences 191
78,18,32,63,191,parasitology,Natural Sciences,78 18 32 63 Natural Sciences 191
64,76,36,15,191,parasitology,Natural Sciences,64 76 36 15 Natural Sciences 191
71,2,47,71,191,parasitology,Natural Sciences,71 2 47 71 Natural Sciences 191
25,2,68,96,191,parasitology,Natural Sciences,25 2 68 96 Natural Sciences 191
9,68,58,56,191,parasitology,Natural Sciences,9 68 58 56 Natural Sciences 191
57,34,39,61,191,parasitology,Natural Sciences,57 34 39 61 Natural Sciences 191
51,60,9,71,191,parasitology,Natural Sciences,51 60 9 71 Natural Sciences 191
85,4,5,97,191,parasitology,Natural Sciences,85 4 5 97 Natural Sciences 191
39,47,74,31,191,parasitology,Natural Sciences,39 47 74 31 Natural Sciences 191
53,92,38,8,191,parasitology,Natural Sciences,53 92 38 8 Natural Sciences 191
62,21,30,78,191,parasitology,Natural Sciences,62 21 30 78 Natural Sciences 191
84,72,22,13,191,parasitology,Natural Sciences,84 72 22 13 Natural Sciences 191
18,69,31,73,191,parasitology,Natural Sciences,18 69 31 73 Natural Sciences 191
68,2,88,33,191,parasitology,Natural Sciences,68 2 88 33 Natural Sciences 191
19,3,83,86,191,parasitology,Natural Sciences,19 3 83 86 Natural Sciences 191
7,77,56,51,191,parasitology,Natural Sciences,7 77 56 51 Natural Sciences 191
39,68,22,62,191,parasitology,Natural Sciences,39 68 22 62 Natural Sciences 191
35,93,8,55,191,parasitology,Natural Sciences,35 93 8 55 Natural Sciences 191
92,71,16,12,191,parasitology,Natural Sciences,92 71 16 12 Natural Sciences 191
40,40,90,21,191,parasitology,Natural Sciences,40 40 90 21 Natural Sciences 191
13,60,52,66,191,parasitology,Natural Sciences,13 60 52 66 Natural Sciences 191
30,81,77,3,191,parasitology,Natural Sciences,30 81 77 3 Natural Sciences 191
58,33,64,36,191,parasitology,Natural Sciences,58 33 64 36 Natural Sciences 191
85,72,33,1,191,parasitology,Natural Sciences,85 72 33 1 Natural Sciences 191
49,43,27,72,191,parasitology,Natural Sciences,49 43 27 72 Natural Sciences 191
25,90,40,36,191,parasitology,Natural Sciences,25 90 40 36 Natural Sciences 191
83,50,54,4,191,parasitology,Natural Sciences,83 50 54 4 Natural Sciences 191
77,25,55,34,191,parasitology,Natural Sciences,77 25 55 34 Natural Sciences 191
21,48,26,96,191,parasitology,Natural Sciences,21 48 26 96 Natural Sciences 191
54,38,17,82,191,parasitology,Natural Sciences,54 38 17 82 Natural Sciences 191
28,66,47,51,192,parasitology,Natural Sciences,28 66 47 51 Natural Sciences 192
28,94,51,19,192,parasitology,Natural Sciences,28 94 51 19 Natural Sciences 192
84,93,3,12,192,parasitology,Natural Sciences,84 93 3 12 Natural Sciences 192
35,25,52,80,192,parasitology,Natural Sciences,35 25 52 80 Natural Sciences 192
73,74,2,43,192,parasitology,Natural Sciences,73 74 2 43 Natural Sciences 192
50,40,64,38,192,parasitology,Natural Sciences,50 40 64 38 Natural Sciences 192
46,27,89,30,192,parasitology,Natural Sciences,46 27 89 30 Natural Sciences 192
49,78,59,6,192,parasitology,Natural Sciences,49 78 59 6 Natural Sciences 192
34,82,39,37,192,parasitology,Natural Sciences,34 82 39 37 Natural Sciences 192
5,29,66,92,192,parasitology,Natural Sciences,5 29 66 92 Natural Sciences 192
12,50,71,59,192,parasitology,Natural Sciences,12 50 71 59 Natural Sciences 192
15,42,53,82,192,parasitology,Natural Sciences,15 42 53 82 Natural Sciences 192
23,35,47,87,192,parasitology,Natural Sciences,23 35 47 87 Natural Sciences 192
48,37,46,61,192,parasitology,Natural Sciences,48 37 46 61 Natural Sciences 192
74,20,49,49,192,parasitology,Natural Sciences,74 20 49 49 Natural Sciences 192
77,56,28,31,192,parasitology,Natural Sciences,77 56 28 31 Natural Sciences 192
11,56,44,81,192,parasitology,Natural Sciences,11 56 44 81 Natural Sciences 192
37,62,71,22,192,parasitology,Natural Sciences,37 62 71 22 Natural Sciences 192
39,31,50,72,192,parasitology,Natural Sciences,39 31 50 72 Natural Sciences 192
37,51,55,49,192,parasitology,Natural Sciences,37 51 55 49 Natural Sciences 192
66,4,25,97,192,parasitology,Natural Sciences,66 4 25 97 Natural Sciences 192
43,58,28,63,192,parasitology,Natural Sciences,43 58 28 63 Natural Sciences 192
98,28,31,35,192,parasitology,Natural Sciences,98 28 31 35 Natural Sciences 192
99,16,63,14,192,parasitology,Natural Sciences,99 16 63 14 Natural Sciences 192
46,81,46,19,192,parasitology,Natural Sciences,46 81 46 19 Natural Sciences 192
4,89,27,72,192,parasitology,Natural Sciences,4 89 27 72 Natural Sciences 192
61,43,44,44,192,parasitology,Natural Sciences,61 43 44 44 Natural Sciences 192
74,51,0,67,192,parasitology,Natural Sciences,74 51 0 67 Natural Sciences 192
99,10,69,14,192,parasitology,Natural Sciences,99 10 69 14 Natural Sciences 192
66,0,84,42,192,parasitology,Natural Sciences,66 0 84 42 Natural Sciences 192
74,22,9,87,192,parasitology,Natural Sciences,74 22 9 87 Natural Sciences 192
70,40,3,79,192,parasitology,Natural Sciences,70 40 3 79 Natural Sciences 192
68,15,94,15,192,parasitology,Natural Sciences,68 15 94 15 Natural Sciences 192
50,40,20,82,192,parasitology,Natural Sciences,50 40 20 82 Natural Sciences 192
87,80,20,5,192,parasitology,Natural Sciences,87 80 20 5 Natural Sciences 192
71,8,38,75,192,parasitology,Natural Sciences,71 8 38 75 Natural Sciences 192
21,24,77,70,192,parasitology,Natural Sciences,21 24 77 70 Natural Sciences 192
54,76,13,49,192,parasitology,Natural Sciences,54 76 13 49 Natural Sciences 192
33,31,96,32,192,parasitology,Natural Sciences,33 31 96 32 Natural Sciences 192
78,20,21,73,192,parasitology,Natural Sciences,78 20 21 73 Natural Sciences 192
99,7,79,8,193,parasitology,Natural Sciences,99 7 79 8 Natural Sciences 193
16,100,50,27,193,parasitology,Natural Sciences,16 100 50 27 Natural Sciences 193
66,4,29,94,193,parasitology,Natural Sciences,66 4 29 94 Natural Sciences 193
32,59,49,53,193,parasitology,Natural Sciences,32 59 49 53 Natural Sciences 193
29,50,66,48,193,parasitology,Natural Sciences,29 50 66 48 Natural Sciences 193
46,76,20,51,193,parasitology,Natural Sciences,46 76 20 51 Natural Sciences 193
19,70,77,27,193,parasitology,Natural Sciences,19 70 77 27 Natural Sciences 193
60,39,41,53,193,parasitology,Natural Sciences,60 39 41 53 Natural Sciences 193
89,5,79,20,193,parasitology,Natural Sciences,89 5 79 20 Natural Sciences 193
54,68,13,58,193,parasitology,Natural Sciences,54 68 13 58 Natural Sciences 193
59,29,47,58,193,parasitology,Natural Sciences,59 29 47 58 Natural Sciences 193
38,82,24,49,193,parasitology,Natural Sciences,38 82 24 49 Natural Sciences 193
12,31,54,96,193,parasitology,Natural Sciences,12 31 54 96 Natural Sciences 193
98,2,63,30,193,parasitology,Natural Sciences,98 2 63 30 Natural Sciences 193
0,23,89,81,193,parasitology,Natural Sciences,0 23 89 81 Natural Sciences 193
46,36,30,81,193,parasitology,Natural Sciences,46 36 30 81 Natural Sciences 193
81,18,86,8,193,parasitology,Natural Sciences,81 18 86 8 Natural Sciences 193
15,52,58,68,193,parasitology,Natural Sciences,15 52 58 68 Natural Sciences 193
24,79,26,64,193,parasitology,Natural Sciences,24 79 26 64 Natural Sciences 193
15,90,32,56,193,parasitology,Natural Sciences,15 90 32 56 Natural Sciences 193
25,35,57,76,193,parasitology,Natural Sciences,25 35 57 76 Natural Sciences 193
66,30,96,1,193,parasitology,Natural Sciences,66 30 96 1 Natural Sciences 193
85,57,38,13,193,parasitology,Natural Sciences,85 57 38 13 Natural Sciences 193
55,86,42,10,193,parasitology,Natural Sciences,55 86 42 10 Natural Sciences 193
62,82,35,14,193,parasitology,Natural Sciences,62 82 35 14 Natural Sciences 193
58,17,42,76,193,parasitology,Natural Sciences,58 17 42 76 Natural Sciences 193
21,91,14,67,193,parasitology,Natural Sciences,21 91 14 67 Natural Sciences 193
12,19,73,89,193,parasitology,Natural Sciences,12 19 73 89 Natural Sciences 193
33,92,42,26,193,parasitology,Natural Sciences,33 92 42 26 Natural Sciences 193
15,19,90,69,193,parasitology,Natural Sciences,15 19 90 69 Natural Sciences 193
50,60,44,39,193,parasitology,Natural Sciences,50 60 44 39 Natural Sciences 193
39,51,19,84,193,parasitology,Natural Sciences,39 51 19 84 Natural Sciences 193
90,0,95,8,193,parasitology,Natural Sciences,90 0 95 8 Natural Sciences 193
16,75,33,69,193,parasitology,Natural Sciences,16 75 33 69 Natural Sciences 193
96,1,4,92,193,parasitology,Natural Sciences,96 1 4 92 Natural Sciences 193
49,29,45,71,194,parasitology,Natural Sciences,49 29 45 71 Natural Sciences 194
18,54,46,76,194,parasitology,Natural Sciences,18 54 46 76 Natural Sciences 194
57,84,47,6,194,parasitology,Natural Sciences,57 84 47 6 Natural Sciences 194
47,38,49,60,194,parasitology,Natural Sciences,47 38 49 60 Natural Sciences 194
82,6,7,99,194,parasitology,Natural Sciences,82 6 7 99 Natural Sciences 194
96,12,41,45,194,parasitology,Natural Sciences,96 12 41 45 Natural Sciences 194
29,53,42,70,194,parasitology,Natural Sciences,29 53 42 70 Natural Sciences 194
75,28,54,37,194,parasitology,Natural Sciences,75 28 54 37 Natural Sciences 194
92,0,9,93,194,parasitology,Natural Sciences,92 0 9 93 Natural Sciences 194
76,8,51,59,194,parasitology,Natural Sciences,76 8 51 59 Natural Sciences 194
100,1,2,91,194,parasitology,Natural Sciences,100 1 2 91 Natural Sciences 194
55,36,4,99,194,parasitology,Natural Sciences,55 36 4 99 Natural Sciences 194
79,40,68,7,194,parasitology,Natural Sciences,79 40 68 7 Natural Sciences 194
48,68,28,50,194,parasitology,Natural Sciences,48 68 28 50 Natural Sciences 194
42,86,25,41,194,parasitology,Natural Sciences,42 86 25 41 Natural Sciences 194
74,87,8,25,194,parasitology,Natural Sciences,74 87 8 25 Natural Sciences 194
16,69,47,62,194,parasitology,Natural Sciences,16 69 47 62 Natural Sciences 194
28,86,45,35,194,parasitology,Natural Sciences,28 86 45 35 Natural Sciences 194
41,38,79,36,194,parasitology,Natural Sciences,41 38 79 36 Natural Sciences 194
26,71,29,68,194,parasitology,Natural Sciences,26 71 29 68 Natural Sciences 194
66,70,47,11,194,parasitology,Natural Sciences,66 70 47 11 Natural Sciences 194
12,50,67,65,194,parasitology,Natural Sciences,12 50 67 65 Natural Sciences 194
50,54,6,84,194,parasitology,Natural Sciences,50 54 6 84 Natural Sciences 194
45,88,55,6,194,parasitology,Natural Sciences,45 88 55 6 Natural Sciences 194
72,60,37,25,194,parasitology,Natural Sciences,72 60 37 25 Natural Sciences 194
86,22,33,53,194,parasitology,Natural Sciences,86 22 33 53 Natural Sciences 194
23,41,87,43,194,parasitology,Natural Sciences,23 41 87 43 Natural Sciences 194
18,58,32,86,194,parasitology,Natural Sciences,18 58 32 86 Natural Sciences 194
2,44,86,62,194,parasitology,Natural Sciences,2 44 86 62 Natural Sciences 194
28,89,22,55,194,parasitology,Natural Sciences,28 89 22 55 Natural Sciences 194
5,100,12,77,194,parasitology,Natural Sciences,5 100 12 77 Natural Sciences 194
98,0,52,44,194,parasitology,Natural Sciences,98 0 52 44 Natural Sciences 194
53,50,63,28,194,parasitology,Natural Sciences,53 50 63 28 Natural Sciences 194
19,82,58,35,194,parasitology,Natural Sciences,19 82 58 35 Natural Sciences 194
45,50,49,50,194,parasitology,Natural Sciences,45 50 49 50 Natural Sciences 194
71,8,32,83,194,parasitology,Natural Sciences,71 8 32 83 Natural Sciences 194
23,27,93,51,194,parasitology,Natural Sciences,23 27 93 51 Natural Sciences 194
47,48,27,72,194,parasitology,Natural Sciences,47 48 27 72 Natural Sciences 194
81,4,32,77,194,parasitology,Natural Sciences,81 4 32 77 Natural Sciences 194
78,36,23,57,194,parasitology,Natural Sciences,78 36 23 57 Natural Sciences 194
4,8,89,93,194,parasitology,Natural Sciences,4 8 89 93 Natural Sciences 194
57,17,57,63,194,parasitology,Natural Sciences,57 17 57 63 Natural Sciences 194
37,88,26,43,194,parasitology,Natural Sciences,37 88 26 43 Natural Sciences 194
53,52,16,73,194,parasitology,Natural Sciences,53 52 16 73 Natural Sciences 194
81,13,58,42,194,parasitology,Natural Sciences,81 13 58 42 Natural Sciences 194
36,82,30,46,194,parasitology,Natural Sciences,36 82 30 46 Natural Sciences 194
35,60,78,21,194,parasitology,Natural Sciences,35 60 78 21 Natural Sciences 194
33,86,9,66,194,parasitology,Natural Sciences,33 86 9 66 Natural Sciences 194
29,51,21,93,194,parasitology,Natural Sciences,29 51 21 93 Natural Sciences 194
38,36,61,60,195,parasitology,Natural Sciences,38 36 61 60 Natural Sciences 195
65,7,40,83,195,parasitology,Natural Sciences,65 7 40 83 Natural Sciences 195
71,51,12,61,195,parasitology,Natural Sciences,71 51 12 61 Natural Sciences 195
63,7,49,76,195,parasitology,Natural Sciences,63 7 49 76 Natural Sciences 195
43,80,63,9,195,parasitology,Natural Sciences,43 80 63 9 Natural Sciences 195
97,40,34,24,195,parasitology,Natural Sciences,97 40 34 24 Natural Sciences 195
37,92,19,47,195,parasitology,Natural Sciences,37 92 19 47 Natural Sciences 195
48,56,40,51,195,parasitology,Natural Sciences,48 56 40 51 Natural Sciences 195
80,50,4,61,195,parasitology,Natural Sciences,80 50 4 61 Natural Sciences 195
34,57,50,54,195,parasitology,Natural Sciences,34 57 50 54 Natural Sciences 195
59,54,37,45,195,parasitology,Natural Sciences,59 54 37 45 Natural Sciences 195
26,66,11,92,195,parasitology,Natural Sciences,26 66 11 92 Natural Sciences 195
47,50,48,50,195,parasitology,Natural Sciences,47 50 48 50 Natural Sciences 195
39,85,41,30,195,parasitology,Natural Sciences,39 85 41 30 Natural Sciences 195
90,41,54,10,195,parasitology,Natural Sciences,90 41 54 10 Natural Sciences 195
43,37,49,66,195,parasitology,Natural Sciences,43 37 49 66 Natural Sciences 195
57,54,47,37,195,parasitology,Natural Sciences,57 54 47 37 Natural Sciences 195
83,50,48,14,195,parasitology,Natural Sciences,83 50 48 14 Natural Sciences 195
73,28,65,29,195,parasitology,Natural Sciences,73 28 65 29 Natural Sciences 195
44,71,75,5,195,parasitology,Natural Sciences,44 71 75 5 Natural Sciences 195
96,11,62,26,195,parasitology,Natural Sciences,96 11 62 26 Natural Sciences 195
50,12,79,54,195,parasitology,Natural Sciences,50 12 79 54 Natural Sciences 195
52,19,42,82,195,parasitology,Natural Sciences,52 19 42 82 Natural Sciences 195
19,34,55,87,195,parasitology,Natural Sciences,19 34 55 87 Natural Sciences 195
7,90,85,13,195,parasitology,Natural Sciences,7 90 85 13 Natural Sciences 195
35,61,38,61,195,parasitology,Natural Sciences,35 61 38 61 Natural Sciences 195
66,26,51,52,195,parasitology,Natural Sciences,66 26 51 52 Natural Sciences 195
68,18,22,87,195,parasitology,Natural Sciences,68 18 22 87 Natural Sciences 195
36,39,32,88,195,parasitology,Natural Sciences,36 39 32 88 Natural Sciences 195
86,14,80,15,195,parasitology,Natural Sciences,86 14 80 15 Natural Sciences 195
92,15,87,1,195,parasitology,Natural Sciences,92 15 87 1 Natural Sciences 195
62,75,14,44,195,parasitology,Natural Sciences,62 75 14 44 Natural Sciences 195
17,73,27,78,195,parasitology,Natural Sciences,17 73 27 78 Natural Sciences 195
97,62,27,9,195,parasitology,Natural Sciences,97 62 27 9 Natural Sciences 195
57,23,53,62,195,parasitology,Natural Sciences,57 23 53 62 Natural Sciences 195
95,81,7,12,195,parasitology,Natural Sciences,95 81 7 12 Natural Sciences 195
60,79,29,27,195,parasitology,Natural Sciences,60 79 29 27 Natural Sciences 195
88,20,70,17,195,parasitology,Natural Sciences,88 20 70 17 Natural Sciences 195
34,74,52,35,195,parasitology,Natural Sciences,34 74 52 35 Natural Sciences 195
57,50,52,36,195,parasitology,Natural Sciences,57 50 52 36 Natural Sciences 195
73,92,24,6,195,parasitology,Natural Sciences,73 92 24 6 Natural Sciences 195
69,50,59,17,195,parasitology,Natural Sciences,69 50 59 17 Natural Sciences 195
33,92,40,31,196,radiography,Health Sciences,33 92 40 31 Health Sciences 196
9,1,87,99,196,radiography,Health Sciences,9 1 87 99 Health Sciences 196
44,83,60,9,196,radiography,Health Sciences,44 83 60 9 Health Sciences 196
21,80,46,49,196,radiography,Health Sciences,21 80 46 49 Health Sciences 196
21,94,59,22,196,radiography,Health Sciences,21 94 59 22 Health Sciences 196
91,77,3,25,196,radiography,Health Sciences,91 77 3 25 Health Sciences 196
17,95,47,37,196,radiography,Health Sciences,17 95 47 37 Health Sciences 196
96,50,47,3,196,radiography,Health Sciences,96 50 47 3 Health Sciences 196
62,49,16,69,196,radiography,Health Sciences,62 49 16 69 Health Sciences 196
37,42,40,77,196,radiography,Health Sciences,37 42 40 77 Health Sciences 196
97,4,30,65,196,radiography,Health Sciences,97 4 30 65 Health Sciences 196
52,53,45,46,196,radiography,Health Sciences,52 53 45 46 Health Sciences 196
61,40,63,32,196,radiography,Health Sciences,61 40 63 32 Health Sciences 196
24,100,57,15,196,radiography,Health Sciences,24 100 57 15 Health Sciences 196
59,30,87,20,196,radiography,Health Sciences,59 30 87 20 Health Sciences 196
33,54,71,38,196,radiography,Health Sciences,33 54 71 38 Health Sciences 196
24,98,17,57,196,radiography,Health Sciences,24 98 17 57 Health Sciences 196
80,89,13,14,196,radiography,Health Sciences,80 89 13 14 Health Sciences 196
53,31,27,85,196,radiography,Health Sciences,53 31 27 85 Health Sciences 196
55,2,42,97,196,radiography,Health Sciences,55 2 42 97 Health Sciences 196
38,19,45,94,196,radiography,Health Sciences,38 19 45 94 Health Sciences 196
36,18,43,99,196,radiography,Health Sciences,36 18 43 99 Health Sciences 196
29,73,87,7,196,radiography,Health Sciences,29 73 87 7 Health Sciences 196
12,82,71,31,196,radiography,Health Sciences,12 82 71 31 Health Sciences 196
27,78,37,54,196,radiography,Health Sciences,27 78 37 54 Health Sciences 196
48,66,37,45,196,radiography,Health Sciences,48 66 37 45 Health Sciences 196
50,22,81,43,196,radiography,Health Sciences,50 22 81 43 Health Sciences 196
40,64,50,42,196,radiography,Health Sciences,40 64 50 42 Health Sciences 196
14,73,58,51,196,radiography,Health Sciences,14 73 58 51 Health Sciences 196
42,36,35,83,196,radiography,Health Sciences,42 36 35 83 Health Sciences 196
87,97,10,2,196,radiography,Health Sciences,87 97 10 2 Health Sciences 196
0,72,85,39,196,radiography,Health Sciences,0 72 85 39 Health Sciences 196
78,30,26,62,196,radiography,Health Sciences,78 30 26 62 Health Sciences 196
66,81,11,38,196,radiography,Health Sciences,66 81 11 38 Health Sciences 196
92,15,64,25,196,radiography,Health Sciences,92 15 64 25 Health Sciences 196
35,76,16,69,196,radiography,Health Sciences,35 76 16 69 Health Sciences 196
93,8,57,38,196,radiography,Health Sciences,93 8 57 38 Health Sciences 196
78,8,52,58,196,radiography,Health Sciences,78 8 52 58 Health Sciences 196
50,52,62,32,196,radiography,Health Sciences,50 52 62 32 Health Sciences 196
16,74,68,39,197,radiography,Health Sciences,16 74 68 39 Health Sciences 197
54,36,57,50,197,radiography,Health Sciences,54 36 57 50 Health Sciences 197
94,15,64,24,197,radiography,Health Sciences,94 15 64 24 Health Sciences 197
50,55,84,8,197,radiography,Health Sciences,50 55 84 8 Health Sciences 197
73,45,47,32,197,radiography,Health Sciences,73 45 47 32 Health Sciences 197
29,50,74,44,197,radiography,Health Sciences,29 50 74 44 Health Sciences 197
69,22,21,85,197,radiography,Health Sciences,69 22 21 85 Health Sciences 197
86,24,34,53,197,radiography,Health Sciences,86 24 34 53 Health Sciences 197
46,71,62,18,197,radiography,Health Sciences,46 71 62 18 Health Sciences 197
50,82,1,64,197,radiography,Health Sciences,50 82 1 64 Health Sciences 197
64,25,31,77,197,radiography,Health Sciences,64 25 31 77 Health Sciences 197
90,29,68,10,197,radiography,Health Sciences,90 29 68 10 Health Sciences 197
65,84,14,34,197,radiography,Health Sciences,65 84 14 34 Health Sciences 197
72,20,8,97,197,radiography,Health Sciences,72 20 8 97 Health Sciences 197
90,26,31,50,197,radiography,Health Sciences,90 26 31 50 Health Sciences 197
40,39,55,63,197,radiography,Health Sciences,40 39 55 63 Health Sciences 197
12,34,99,52,197,radiography,Health Sciences,12 34 99 52 Health Sciences 197
91,0,76,30,197,radiography,Health Sciences,91 0 76 30 Health Sciences 197
69,38,58,32,197,radiography,Health Sciences,69 38 58 32 Health Sciences 197
6,100,6,85,197,radiography,Health Sciences,6 100 6 85 Health Sciences 197
99,2,26,70,197,radiography,Health Sciences,99 2 26 70 Health Sciences 197
29,54,78,36,197,radiography,Health Sciences,29 54 78 36 Health Sciences 197
62,24,95,16,197,radiography,Health Sciences,62 24 95 16 Health Sciences 197
44,67,66,20,197,radiography,Health Sciences,44 67 66 20 Health Sciences 197
48,14,65,70,197,radiography,Health Sciences,48 14 65 70 Health Sciences 197
35,43,54,65,197,radiography,Health Sciences,35 43 54 65 Health Sciences 197
48,72,25,52,197,radiography,Health Sciences,48 72 25 52 Health Sciences 197
43,68,66,20,197,radiography,Health Sciences,43 68 66 20 Health Sciences 197
57,99,24,17,197,radiography,Health Sciences,57 99 24 17 Health Sciences 197
7,59,59,72,197,radiography,Health Sciences,7 59 59 72 Health Sciences 197
87,36,45,29,197,radiography,Health Sciences,87 36 45 29 Health Sciences 197
46,88,46,17,197,radiography,Health Sciences,46 88 46 17 Health Sciences 197
39,42,50,66,197,radiography,Health Sciences,39 42 50 66 Health Sciences 197
69,74,23,31,197,radiography,Health Sciences,69 74 23 31 Health Sciences 197
9,46,60,82,197,radiography,Health Sciences,9 46 60 82 Health Sciences 197
40,70,27,60,197,radiography,Health Sciences,40 70 27 60 Health Sciences 197
9,64,36,88,197,radiography,Health Sciences,9 64 36 88 Health Sciences 197
17,42,61,77,197,radiography,Health Sciences,17 42 61 77 Health Sciences 197
97,3,62,35,197,radiography,Health Sciences,97 3 62 35 Health Sciences 197
22,17,69,90,198,radiography,Health Sciences,22 17 69 90 Health Sciences 198
41,65,53,39,198,radiography,Health Sciences,41 65 53 39 Health Sciences 198
75,37,20,66,198,radiography,Health Sciences,75 37 20 66 Health Sciences 198
97,49,23,29,198,radiography,Health Sciences,97 49 23 29 Health Sciences 198
45,2,91,60,198,radiography,Health Sciences,45 2 91 60 Health Sciences 198
4,39,94,61,198,radiography,Health Sciences,4 39 94 61 Health Sciences 198
51,54,40,53,198,radiography,Health Sciences,51 54 40 53 Health Sciences 198
59,99,14,26,198,radiography,Health Sciences,59 99 14 26 Health Sciences 198
66,38,85,9,198,radiography,Health Sciences,66 38 85 9 Health Sciences 198
84,18,93,3,198,radiography,Health Sciences,84 18 93 3 Health Sciences 198
98,13,2,85,198,radiography,Health Sciences,98 13 2 85 Health Sciences 198
43,70,32,53,198,radiography,Health Sciences,43 70 32 53 Health Sciences 198
55,38,37,68,198,radiography,Health Sciences,55 38 37 68 Health Sciences 198
80,25,59,34,198,radiography,Health Sciences,80 25 59 34 Health Sciences 198
62,90,16,30,198,radiography,Health Sciences,62 90 16 30 Health Sciences 198
26,76,81,15,198,radiography,Health Sciences,26 76 81 15 Health Sciences 198
13,70,43,72,198,radiography,Health Sciences,13 70 43 72 Health Sciences 198
94,57,38,9,198,radiography,Health Sciences,94 57 38 9 Health Sciences 198
91,38,38,31,198,radiography,Health Sciences,91 38 38 31 Health Sciences 198
79,1,69,49,198,radiography,Health Sciences,79 1 69 49 Health Sciences 198
72,3,53,70,198,radiography,Health Sciences,72 3 53 70 Health Sciences 198
65,14,31,88,198,radiography,Health Sciences,65 14 31 88 Health Sciences 198
92,2,89,15,198,radiography,Health Sciences,92 2 89 15 Health Sciences 198
73,41,31,53,198,radiography,Health Sciences,73 41 31 53 Health Sciences 198
21,70,59,48,198,radiography,Health Sciences,21 70 59 48 Health Sciences 198
52,24,51,71,198,radiography,Health Sciences,52 24 51 71 Health Sciences 198
67,11,60,60,198,radiography,Health Sciences,67 11 60 60 Health Sciences 198
50,77,18,53,198,radiography,Health Sciences,50 77 18 53 Health Sciences 198
18,80,51,49,198,radiography,Health Sciences,18 80 51 49 Health Sciences 198
34,22,43,99,198,radiography,Health Sciences,34 22 43 99 Health Sciences 198
16,82,38,62,198,radiography,Health Sciences,16 82 38 62 Health Sciences 198
50,39,97,12,198,radiography,Health Sciences,50 39 97 12 Health Sciences 198
67,48,9,74,198,radiography,Health Sciences,67 48 9 74 Health Sciences 198
71,23,6,99,199,radiography,Health Sciences,71 23 6 99 Health Sciences 199
29,54,17,99,199,radiography,Health Sciences,29 54 17 99 Health Sciences 199
48,34,36,81,199,radiography,Health Sciences,48 34 36 81 Health Sciences 199
62,45,42,50,199,radiography,Health Sciences,62 45 42 50 Health Sciences 199
60,37,82,20,199,radiography,Health Sciences,60 37 82 20 Health Sciences 199
36,0,78,85,199,radiography,Health Sciences,36 0 78 85 Health Sciences 199
85,29,32,53,199,radiography,Health Sciences,85 29 32 53 Health Sciences 199
60,36,34,69,199,radiography,Health Sciences,60 36 34 69 Health Sciences 199
98,16,72,13,199,radiography,Health Sciences,98 16 72 13 Health Sciences 199
26,27,70,76,199,radiography,Health Sciences,26 27 70 76 Health Sciences 199
29,30,66,74,199,radiography,Health Sciences,29 30 66 74 Health Sciences 199
56,28,64,51,199,radiography,Health Sciences,56 28 64 51 Health Sciences 199
91,86,11,11,199,radiography,Health Sciences,91 86 11 11 Health Sciences 199
22,86,52,39,199,radiography,Health Sciences,22 86 52 39 Health Sciences 199
82,83,11,23,199,radiography,Health Sciences,82 83 11 23 Health Sciences 199
17,38,52,92,199,radiography,Health Sciences,17 38 52 92 Health Sciences 199
64,40,59,36,199,radiography,Health Sciences,64 40 59 36 Health Sciences 199
49,33,28,89,199,radiography,Health Sciences,49 33 28 89 Health Sciences 199
73,31,67,28,199,radiography,Health Sciences,73 31 67 28 Health Sciences 199
23,47,59,70,199,radiography,Health Sciences,23 47 59 70 Health Sciences 199
7,32,93,67,199,radiography,Health Sciences,7 32 93 67 Health Sciences 199
36,31,73,59,199,radiography,Health Sciences,36 31 73 59 Health Sciences 199
35,86,50,28,199,radiography,Health Sciences,35 86 50 28 Health Sciences 199
0,7,97,95,199,radiography,Health Sciences,0 7 97 95 Health Sciences 199
72,24,8,95,199,radiography,Health Sciences,72 24 8 95 Health Sciences 199
18,13,94,74,199,radiography,Health Sciences,18 13 94 74 Health Sciences 199
50,51,64,34,199,radiography,Health Sciences,50 51 64 34 Health Sciences 199
60,33,59,47,199,radiography,Health Sciences,60 33 59 47 Health Sciences 199
70,72,19,38,199,radiography,Health Sciences,70 72 19 38 Health Sciences 199
99,49,10,41,199,radiography,Health Sciences,99 49 10 41 Health Sciences 199
100,35,26,38,199,radiography,Health Sciences,100 35 26 38 Health Sciences 199
58,35,94,12,199,radiography,Health Sciences,58 35 94 12 Health Sciences 199
43,95,41,20,199,radiography,Health Sciences,43 95 41 20 Health Sciences 199
57,49,33,60,199,radiography,Health Sciences,57 49 33 60 Health Sciences 199
86,62,18,33,199,radiography,Health Sciences,86 62 18 33 Health Sciences 199
65,0,82,52,199,radiography,Health Sciences,65 0 82 52 Health Sciences 199
50,49,50,50,199,radiography,Health Sciences,50 49 50 50 Health Sciences 199
0,17,83,99,199,radiography,Health Sciences,0 17 83 99 Health Sciences 199
31,86,49,33,199,radiography,Health Sciences,31 86 49 33 Health Sciences 199
56,24,68,51,199,radiography,Health Sciences,56 24 68 51 Health Sciences 199
44,19,67,69,199,radiography,Health Sciences,44 19 67 69 Health Sciences 199
87,91,13,9,200,radiography,Health Sciences,87 91 13 9 Health Sciences 200
5,53,68,74,200,radiography,Health Sciences,5 53 68 74 Health Sciences 200
31,57,51,61,200,radiography,Health Sciences,31 57 51 61 Health Sciences 200
41,92,63,4,200,radiography,Health Sciences,41 92 63 4 Health Sciences 200
69,75,5,51,200,radiography,Health Sciences,69 75 5 51 Health Sciences 200
87,39,24,50,200,radiography,Health Sciences,87 39 24 50 Health Sciences 200
82,44,59,15,200,radiography,Health Sciences,82 44 59 15 Health Sciences 200
89,24,10,77,200,radiography,Health Sciences,89 24 10 77 Health Sciences 200
0,76,46,78,200,radiography,Health Sciences,0 76 46 78 Health Sciences 200
6,73,69,52,200,radiography,Health Sciences,6 73 69 52 Health Sciences 200
38,36,68,58,200,radiography,Health Sciences,38 36 68 58 Health Sciences 200
19,26,65,90,200,radiography,Health Sciences,19 26 65 90 Health Sciences 200
19,46,92,43,200,radiography,Health Sciences,19 46 92 43 Health Sciences 200
86,54,23,37,200,radiography,Health Sciences,86 54 23 37 Health Sciences 200
43,64,45,48,200,radiography,Health Sciences,43 64 45 48 Health Sciences 200
95,4,79,22,200,radiography,Health Sciences,95 4 79 22 Health Sciences 200
0,28,97,75,200,radiography,Health Sciences,0 28 97 75 Health Sciences 200
34,81,47,38,200,radiography,Health Sciences,34 81 47 38 Health Sciences 200
15,53,35,97,200,radiography,Health Sciences,15 53 35 97 Health Sciences 200
60,22,30,88,200,radiography,Health Sciences,60 22 30 88 Health Sciences 200
27,32,49,92,200,radiography,Health Sciences,27 32 49 92 Health Sciences 200
21,81,66,32,200,radiography,Health Sciences,21 81 66 32 Health Sciences 200
25,64,50,61,200,radiography,Health Sciences,25 64 50 61 Health Sciences 200
50,23,68,59,200,radiography,Health Sciences,50 23 68 59 Health Sciences 200
69,40,8,83,200,radiography,Health Sciences,69 40 8 83 Health Sciences 200
42,18,54,86,200,radiography,Health Sciences,42 18 54 86 Health Sciences 200
55,29,38,78,200,radiography,Health Sciences,55 29 38 78 Health Sciences 200
10,50,55,85,200,radiography,Health Sciences,10 50 55 85 Health Sciences 200
28,96,30,46,200,radiography,Health Sciences,28 96 30 46 Health Sciences 200
38,5,75,82,200,radiography,Health Sciences,38 5 75 82 Health Sciences 200
89,2,91,18,200,radiography,Health Sciences,89 2 91 18 Health Sciences 200
16,87,15,82,200,radiography,Health Sciences,16 87 15 82 Health Sciences 200
64,24,57,55,200,radiography,Health Sciences,64 24 57 55 Health Sciences 200
35,44,37,84,200,radiography,Health Sciences,35 44 37 84 Health Sciences 200
13,9,82,96,200,radiography,Health Sciences,13 9 82 96 Health Sciences 200
44,32,50,74,200,radiography,Health Sciences,44 32 50 74 Health Sciences 200
97,14,87,3,201,human nutrition,Agricultural Sciences,97 14 87 3 Agricultural Sciences 201
24,73,5,99,201,human nutrition,Agricultural Sciences,24 73 5 99 Agricultural Sciences 201
60,50,32,59,201,human nutrition,Agricultural Sciences,60 50 32 59 Agricultural Sciences 201
52,17,88,44,201,human nutrition,Agricultural Sciences,52 17 88 44 Agricultural Sciences 201
13,76,34,78,201,human nutrition,Agricultural Sciences,13 76 34 78 Agricultural Sciences 201
68,50,29,54,201,human nutrition,Agricultural Sciences,68 50 29 54 Agricultural Sciences 201
23,76,16,86,201,human nutrition,Agricultural Sciences,23 76 16 86 Agricultural Sciences 201
69,23,46,63,201,human nutrition,Agricultural Sciences,69 23 46 63 Agricultural Sciences 201
87,90,7,17,201,human nutrition,Agricultural Sciences,87 90 7 17 Agricultural Sciences 201
38,84,49,30,201,human nutrition,Agricultural Sciences,38 84 49 30 Agricultural Sciences 201
5,35,66,95,201,human nutrition,Agricultural Sciences,5 35 66 95 Agricultural Sciences 201
88,7,37,69,201,human nutrition,Agricultural Sciences,88 7 37 69 Agricultural Sciences 201
85,19,31,66,201,human nutrition,Agricultural Sciences,85 19 31 66 Agricultural Sciences 201
64,78,13,46,201,human nutrition,Agricultural Sciences,64 78 13 46 Agricultural Sciences 201
52,38,20,91,201,human nutrition,Agricultural Sciences,52 38 20 91 Agricultural Sciences 201
15,45,71,70,201,human nutrition,Agricultural Sciences,15 45 71 70 Agricultural Sciences 201
64,86,12,39,201,human nutrition,Agricultural Sciences,64 86 12 39 Agricultural Sciences 201
0,68,50,83,201,human nutrition,Agricultural Sciences,0 68 50 83 Agricultural Sciences 201
63,61,37,40,201,human nutrition,Agricultural Sciences,63 61 37 40 Agricultural Sciences 201
51,43,55,52,201,human nutrition,Agricultural Sciences,51 43 55 52 Agricultural Sciences 201
46,82,25,48,201,human nutrition,Agricultural Sciences,46 82 25 48 Agricultural Sciences 201
16,81,79,25,201,human nutrition,Agricultural Sciences,16 81 79 25 Agricultural Sciences 201
39,68,52,42,201,human nutrition,Agricultural Sciences,39 68 52 42 Agricultural Sciences 201
68,40,90,3,201,human nutrition,Agricultural Sciences,68 40 90 3 Agricultural Sciences 201
12,64,39,86,201,human nutrition,Agricultural Sciences,12 64 39 86 Agricultural Sciences 201
78,21,22,80,201,human nutrition,Agricultural Sciences,78 21 22 80 Agricultural Sciences 201
20,40,65,76,201,human nutrition,Agricultural Sciences,20 40 65 76 Agricultural Sciences 201
8,89,17,87,201,human nutrition,Agricultural Sciences,8 89 17 87 Agricultural Sciences 201
35,63,25,78,201,human nutrition,Agricultural Sciences,35 63 25 78 Agricultural Sciences 201
66,54,42,39,201,human nutrition,Agricultural Sciences,66 54 42 39 Agricultural Sciences 201
3,23,78,97,201,human nutrition,Agricultural Sciences,3 23 78 97 Agricultural Sciences 201
37,62,69,33,201,human nutrition,Agricultural Sciences,37 62 69 33 Agricultural Sciences 201
44,96,52,9,201,human nutrition,Agricultural Sciences,44 96 52 9 Agricultural Sciences 201
34,41,44,82,201,human nutrition,Agricultural Sciences,34 41 44 82 Agricultural Sciences 201
62,53,64,22,201,human nutrition,Agricultural Sciences,62 53 64 22 Agricultural Sciences 201
42,71,54,34,201,human nutrition,Agricultural Sciences,42 71 54 34 Agricultural Sciences 201
23,78,15,85,201,human nutrition,Agricultural Sciences,23 78 15 85 Agricultural Sciences 201
12,99,5,85,201,human nutrition,Agricultural Sciences,12 99 5 85 Agricultural Sciences 201
60,31,60,50,201,human nutrition,Agricultural Sciences,60 31 60 50 Agricultural Sciences 201
10,59,46,86,201,human nutrition,Agricultural Sciences,10 59 46 86 Agricultural Sciences 201
39,73,61,29,202,human nutrition,Agricultural Sciences,39 73 61 29 Agricultural Sciences 202
32,59,48,63,202,human nutrition,Agricultural Sciences,32 59 48 63 Agricultural Sciences 202
33,47,79,43,202,human nutrition,Agricultural Sciences,33 47 79 43 Agricultural Sciences 202
45,57,50,50,202,human nutrition,Agricultural Sciences,45 57 50 50 Agricultural Sciences 202
87,46,36,33,202,human nutrition,Agricultural Sciences,87 46 36 33 Agricultural Sciences 202
29,75,68,30,202,human nutrition,Agricultural Sciences,29 75 68 30 Agricultural Sciences 202
43,63,72,24,202,human nutrition,Agricultural Sciences,43 63 72 24 Agricultural Sciences 202
48,29,39,86,202,human nutrition,Agricultural Sciences,48 29 39 86 Agricultural Sciences 202
21,79,85,17,202,human nutrition,Agricultural Sciences,21 79 85 17 Agricultural Sciences 202
89,50,43,20,202,human nutrition,Agricultural Sciences,89 50 43 20 Agricultural Sciences 202
94,17,81,10,202,human nutrition,Agricultural Sciences,94 17 81 10 Agricultural Sciences 202
83,58,17,44,202,human nutrition,Agricultural Sciences,83 58 17 44 Agricultural Sciences 202
4,68,51,79,202,human nutrition,Agricultural Sciences,4 68 51 79 Agricultural Sciences 202
16,85,64,37,202,human nutrition,Agricultural Sciences,16 85 64 37 Agricultural Sciences 202
89,66,35,12,202,human nutrition,Agricultural Sciences,89 66 35 12 Agricultural Sciences 202
39,78,27,58,202,human nutrition,Agricultural Sciences,39 78 27 58 Agricultural Sciences 202
45,59,39,59,202,human nutrition,Agricultural Sciences,45 59 39 59 Agricultural Sciences 202
41,81,63,17,202,human nutrition,Agricultural Sciences,41 81 63 17 Agricultural Sciences 202
77,57,52,16,202,human nutrition,Agricultural Sciences,77 57 52 16 Agricultural Sciences 202
4,57,58,83,202,human nutrition,Agricultural Sciences,4 57 58 83 Agricultural Sciences 202
71,93,38,0,202,human nutrition,Agricultural Sciences,71 93 38 0 Agricultural Sciences 202
95,4,62,41,202,human nutrition,Agricultural Sciences,95 4 62 41 Agricultural Sciences 202
11,89,73,29,202,human nutrition,Agricultural Sciences,11 89 73 29 Agricultural Sciences 202
98,12,40,52,202,human nutrition,Agricultural Sciences,98 12 40 52 Agricultural Sciences 202
42,24,65,71,202,human nutrition,Agricultural Sciences,42 24 65 71 Agricultural Sciences 202
67,55,59,21,202,human nutrition,Agricultural Sciences,67 55 59 21 Agricultural Sciences 202
42,21,95,44,202,human nutrition,Agricultural Sciences,42 21 95 44 Agricultural Sciences 202
20,44,87,51,202,human nutrition,Agricultural Sciences,20 44 87 51 Agricultural Sciences 202
43,6,57,96,202,human nutrition,Agricultural Sciences,43 6 57 96 Agricultural Sciences 202
88,43,46,25,202,human nutrition,Agricultural Sciences,88 43 46 25 Agricultural Sciences 202
40,64,17,81,202,human nutrition,Agricultural Sciences,40 64 17 81 Agricultural Sciences 202
77,7,78,40,202,human nutrition,Agricultural Sciences,77 7 78 40 Agricultural Sciences 202
40,10,57,95,202,human nutrition,Agricultural Sciences,40 10 57 95 Agricultural Sciences 202
41,30,52,79,202,human nutrition,Agricultural Sciences,41 30 52 79 Agricultural Sciences 202
76,23,46,57,202,human nutrition,Agricultural Sciences,76 23 46 57 Agricultural Sciences 202
58,79,64,1,202,human nutrition,Agricultural Sciences,58 79 64 1 Agricultural Sciences 202
76,14,34,79,203,human nutrition,Agricultural Sciences,76 14 34 79 Agricultural Sciences 203
76,48,38,41,203,human nutrition,Agricultural Sciences,76 48 38 41 Agricultural Sciences 203
17,83,46,57,203,human nutrition,Agricultural Sciences,17 83 46 57 Agricultural Sciences 203
91,50,20,42,203,human nutrition,Agricultural Sciences,91 50 20 42 Agricultural Sciences 203
65,27,33,78,203,human nutrition,Agricultural Sciences,65 27 33 78 Agricultural Sciences 203
15,77,35,76,203,human nutrition,Agricultural Sciences,15 77 35 76 Agricultural Sciences 203
51,58,76,18,203,human nutrition,Agricultural Sciences,51 58 76 18 Agricultural Sciences 203
36,14,58,95,203,human nutrition,Agricultural Sciences,36 14 58 95 Agricultural Sciences 203
46,26,37,94,203,human nutrition,Agricultural Sciences,46 26 37 94 Agricultural Sciences 203
25,40,64,74,203,human nutrition,Agricultural Sciences,25 40 64 74 Agricultural Sciences 203
16,75,37,75,203,human nutrition,Agricultural Sciences,16 75 37 75 Agricultural Sciences 203
50,50,49,54,203,human nutrition,Agricultural Sciences,50 50 49 54 Agricultural Sciences 203
38,94,21,50,203,human nutrition,Agricultural Sciences,38 94 21 50 Agricultural Sciences 203
21,31,93,58,203,human nutrition,Agricultural Sciences,21 31 93 58 Agricultural Sciences 203
54,37,47,65,203,human nutrition,Agricultural Sciences,54 37 47 65 Agricultural Sciences 203
17,82,45,59,203,human nutrition,Agricultural Sciences,17 82 45 59 Agricultural Sciences 203
45,40,84,34,203,human nutrition,Agricultural Sciences,45 40 84 34 Agricultural Sciences 203
36,76,25,66,203,human nutrition,Agricultural Sciences,36 76 25 66 Agricultural Sciences 203
18,62,92,31,203,human nutrition,Agricultural Sciences,18 62 92 31 Agricultural Sciences 203
53,61,71,18,203,human nutrition,Agricultural Sciences,53 61 71 18 Agricultural Sciences 203
53,72,21,57,203,human nutrition,Agricultural Sciences,53 72 21 57 Agricultural Sciences 203
15,73,28,87,203,human nutrition,Agricultural Sciences,15 73 28 87 Agricultural Sciences 203
0,80,97,26,203,human nutrition,Agricultural Sciences,0 80 97 26 Agricultural Sciences 203
61,90,29,23,203,human nutrition,Agricultural Sciences,61 90 29 23 Agricultural Sciences 203
0,40,71,92,203,human nutrition,Agricultural Sciences,0 40 71 92 Agricultural Sciences 203
46,56,85,16,203,human nutrition,Agricultural Sciences,46 56 85 16 Agricultural Sciences 203
37,48,73,45,203,human nutrition,Agricultural Sciences,37 48 73 45 Agricultural Sciences 203
66,4,63,70,203,human nutrition,Agricultural Sciences,66 4 63 70 Agricultural Sciences 203
92,20,12,79,203,human nutrition,Agricultural Sciences,92 20 12 79 Agricultural Sciences 203
75,23,92,13,203,human nutrition,Agricultural Sciences,75 23 92 13 Agricultural Sciences 203
37,34,75,57,203,human nutrition,Agricultural Sciences,37 34 75 57 Agricultural Sciences 203
13,56,53,81,203,human nutrition,Agricultural Sciences,13 56 53 81 Agricultural Sciences 203
88,57,43,15,203,human nutrition,Agricultural Sciences,88 57 43 15 Agricultural Sciences 203
75,31,58,40,204,human nutrition,Agricultural Sciences,75 31 58 40 Agricultural Sciences 204
98,0,77,29,204,human nutrition,Agricultural Sciences,98 0 77 29 Agricultural Sciences 204
49,22,92,41,204,human nutrition,Agricultural Sciences,49 22 92 41 Agricultural Sciences 204
76,27,65,36,204,human nutrition,Agricultural Sciences,76 27 65 36 Agricultural Sciences 204
62,30,20,92,204,human nutrition,Agricultural Sciences,62 30 20 92 Agricultural Sciences 204
88,70,24,22,204,human nutrition,Agricultural Sciences,88 70 24 22 Agricultural Sciences 204
48,74,29,53,204,human nutrition,Agricultural Sciences,48 74 29 53 Agricultural Sciences 204
7,67,63,67,204,human nutrition,Agricultural Sciences,7 67 63 67 Agricultural Sciences 204
64,87,33,20,204,human nutrition,Agricultural Sciences,64 87 33 20 Agricultural Sciences 204
92,50,32,30,204,human nutrition,Agricultural Sciences,92 50 32 30 Agricultural Sciences 204
64,42,75,23,204,human nutrition,Agricultural Sciences,64 42 75 23 Agricultural Sciences 204
90,26,62,26,204,human nutrition,Agricultural Sciences,90 26 62 26 Agricultural Sciences 204
42,81,63,18,204,human nutrition,Agricultural Sciences,42 81 63 18 Agricultural Sciences 204
44,69,60,31,204,human nutrition,Agricultural Sciences,44 69 60 31 Agricultural Sciences 204
75,26,29,74,204,human nutrition,Agricultural Sciences,75 26 29 74 Agricultural Sciences 204
40,64,69,31,204,human nutrition,Agricultural Sciences,40 64 69 31 Agricultural Sciences 204
9,1,94,100,204,human nutrition,Agricultural Sciences,9 1 94 100 Agricultural Sciences 204
39,56,32,77,204,human nutrition,Agricultural Sciences,39 56 32 77 Agricultural Sciences 204
70,41,51,42,204,human nutrition,Agricultural Sciences,70 41 51 42 Agricultural Sciences 204
14,51,71,68,204,human nutrition,Agricultural Sciences,14 51 71 68 Agricultural Sciences 204
67,84,15,38,204,human nutrition,Agricultural Sciences,67 84 15 38 Agricultural Sciences 204
16,77,44,67,204,human nutrition,Agricultural Sciences,16 77 44 67 Agricultural Sciences 204
15,46,77,66,204,human nutrition,Agricultural Sciences,15 46 77 66 Agricultural Sciences 204
41,86,12,65,204,human nutrition,Agricultural Sciences,41 86 12 65 Agricultural Sciences 204
46,96,11,51,204,human nutrition,Agricultural Sciences,46 96 11 51 Agricultural Sciences 204
88,4,31,81,204,human nutrition,Agricultural Sciences,88 4 31 81 Agricultural Sciences 204
54,86,43,21,204,human nutrition,Agricultural Sciences,54 86 43 21 Agricultural Sciences 204
78,10,45,71,204,human nutrition,Agricultural Sciences,78 10 45 71 Agricultural Sciences 204
80,10,39,75,204,human nutrition,Agricultural Sciences,80 10 39 75 Agricultural Sciences 204
95,6,19,85,205,human nutrition,Agricultural Sciences,95 6 19 85 Agricultural Sciences 205
31,96,22,56,205,human nutrition,Agricultural Sciences,31 96 22 56 Agricultural Sciences 205
10,12,91,92,205,human nutrition,Agricultural Sciences,10 12 91 92 Agricultural Sciences 205
36,42,77,50,205,human nutrition,Agricultural Sciences,36 42 77 50 Agricultural Sciences 205
54,10,64,77,205,human nutrition,Agricultural Sciences,54 10 64 77 Agricultural Sciences 205
57,52,37,59,205,human nutrition,Agricultural Sciences,57 52 37 59 Agricultural Sciences 205
49,91,2,63,205,human nutrition,Agricultural Sciences,49 91 2 63 Agricultural Sciences 205
62,47,41,55,205,human nutrition,Agricultural Sciences,62 47 41 55 Agricultural Sciences 205
62,62,61,20,205,human nutrition,Agricultural Sciences,62 62 61 20 Agricultural Sciences 205
35,37,49,84,205,human nutrition,Agricultural Sciences,35 37 49 84 Agricultural Sciences 205
31,96,69,9,205,human nutrition,Agricultural Sciences,31 96 69 9 Agricultural Sciences 205
78,63,49,15,205,human nutrition,Agricultural Sciences,78 63 49 15 Agricultural Sciences 205
55,77,49,24,205,human nutrition,Agricultural Sciences,55 77 49 24 Agricultural Sciences 205
51,85,29,40,205,human nutrition,Agricultural Sciences,51 85 29 40 Agricultural Sciences 205
85,58,50,12,205,human nutrition,Agricultural Sciences,85 58 50 12 Agricultural Sciences 205
12,85,63,45,205,human nutrition,Agricultural Sciences,12 85 63 45 Agricultural Sciences 205
52,57,32,64,205,human nutrition,Agricultural Sciences,52 57 32 64 Agricultural Sciences 205
86,7,22,90,205,human nutrition,Agricultural Sciences,86 7 22 90 Agricultural Sciences 205
55,96,52,2,205,human nutrition,Agricultural Sciences,55 96 52 2 Agricultural Sciences 205
81,0,89,35,205,human nutrition,Agricultural Sciences,81 0 89 35 Agricultural Sciences 205
79,18,61,47,205,human nutrition,Agricultural Sciences,79 18 61 47 Agricultural Sciences 205
69,84,34,18,205,human nutrition,Agricultural Sciences,69 84 34 18 Agricultural Sciences 205
59,83,17,46,205,human nutrition,Agricultural Sciences,59 83 17 46 Agricultural Sciences 205
32,16,70,87,205,human nutrition,Agricultural Sciences,32 16 70 87 Agricultural Sciences 205
32,60,23,90,205,human nutrition,Agricultural Sciences,32 60 23 90 Agricultural Sciences 205
38,29,77,61,205,human nutrition,Agricultural Sciences,38 29 77 61 Agricultural Sciences 205
90,87,9,19,205,human nutrition,Agricultural Sciences,90 87 9 19 Agricultural Sciences 205
37,88,25,55,205,human nutrition,Agricultural Sciences,37 88 25 55 Agricultural Sciences 205
96,10,47,52,205,human nutrition,Agricultural Sciences,96 10 47 52 Agricultural Sciences 205
48,78,13,66,205,human nutrition,Agricultural Sciences,48 78 13 66 Agricultural Sciences 205
57,83,9,56,205,human nutrition,Agricultural Sciences,57 83 9 56 Agricultural Sciences 205
93,91,9,12,205,human nutrition,Agricultural Sciences,93 91 9 12 Agricultural Sciences 205
31,26,62,86,205,human nutrition,Agricultural Sciences,31 26 62 86 Agricultural Sciences 205
89,25,82,10,206,entomology,Natural Sciences,89 25 82 10 Natural Sciences 206
3,24,85,94,206,entomology,Natural Sciences,3 24 85 94 Natural Sciences 206
25,37,70,74,206,entomology,Natural Sciences,25 37 70 74 Natural Sciences 206
58,91,50,7,206,entomology,Natural Sciences,58 91 50 7 Natural Sciences 206
38,92,9,67,206,entomology,Natural Sciences,38 92 9 67 Natural Sciences 206
47,36,47,76,206,entomology,Natural Sciences,47 36 47 76 Natural Sciences 206
54,90,32,30,206,entomology,Natural Sciences,54 90 32 30 Natural Sciences 206
38,39,37,92,206,entomology,Natural Sciences,38 39 37 92 Natural Sciences 206
73,57,58,18,206,entomology,Natural Sciences,73 57 58 18 Natural Sciences 206
50,14,47,95,206,entomology,Natural Sciences,50 14 47 95 Natural Sciences 206
77,2,36,91,206,entomology,Natural Sciences,77 2 36 91 Natural Sciences 206
74,50,7,75,206,entomology,Natural Sciences,74 50 7 75 Natural Sciences 206
79,47,16,64,206,entomology,Natural Sciences,79 47 16 64 Natural Sciences 206
81,44,49,32,206,entomology,Natural Sciences,81 44 49 32 Natural Sciences 206
43,91,64,8,206,entomology,Natural Sciences,43 91 64 8 Natural Sciences 206
67,71,49,19,206,entomology,Natural Sciences,67 71 49 19 Natural Sciences 206
69,4,85,48,206,entomology,Natural Sciences,69 4 85 48 Natural Sciences 206
64,44,35,63,206,entomology,Natural Sciences,64 44 35 63 Natural Sciences 206
61,37,43,65,206,entomology,Natural Sciences,61 37 43 65 Natural Sciences 206
48,34,57,67,206,entomology,Natural Sciences,48 34 57 67 Natural Sciences 206
81,85,25,15,206,entomology,Natural Sciences,81 85 25 15 Natural Sciences 206
42,88,13,63,206,entomology,Natural Sciences,42 88 13 63 Natural Sciences 206
52,46,10,98,206,entomology,Natural Sciences,52 46 10 98 Natural Sciences 206
91,26,82,7,206,entomology,Natural Sciences,91 26 82 7 Natural Sciences 206
60,41,81,24,206,entomology,Natural Sciences,60 41 81 24 Natural Sciences 206
91,69,14,32,206,entomology,Natural Sciences,91 69 14 32 Natural Sciences 206
54,41,34,77,206,entomology,Natural Sciences,54 41 34 77 Natural Sciences 206
75,10,27,94,206,entomology,Natural Sciences,75 10 27 94 Natural Sciences 206
85,14,84,23,206,entomology,Natural Sciences,85 14 84 23 Natural Sciences 206
41,37,81,47,206,entomology,Natural Sciences,41 37 81 47 Natural Sciences 206
80,19,98,9,206,entomology,Natural Sciences,80 19 98 9 Natural Sciences 206
93,71,18,24,206,entomology,Natural Sciences,93 71 18 24 Natural Sciences 206
37,84,63,22,206,entomology,Natural Sciences,37 84 63 22 Natural Sciences 206
63,44,0,99,206,entomology,Natural Sciences,63 44 0 99 Natural Sciences 206
75,81,19,31,206,entomology,Natural Sciences,75 81 19 31 Natural Sciences 206
69,44,57,36,206,entomology,Natural Sciences,69 44 57 36 Natural Sciences 206
72,27,56,52,207,entomology,Natural Sciences,72 27 56 52 Natural Sciences 207
2,30,77,98,207,entomology,Natural Sciences,2 30 77 98 Natural Sciences 207
59,77,48,23,207,entomology,Natural Sciences,59 77 48 23 Natural Sciences 207
2,54,58,93,207,entomology,Natural Sciences,2 54 58 93 Natural Sciences 207
52,79,40,36,207,entomology,Natural Sciences,52 79 40 36 Natural Sciences 207
76,35,80,16,207,entomology,Natural Sciences,76 35 80 16 Natural Sciences 207
92,26,52,37,207,entomology,Natural Sciences,92 26 52 37 Natural Sciences 207
20,62,33,92,207,entomology,Natural Sciences,20 62 33 92 Natural Sciences 207
94,67,19,27,207,entomology,Natural Sciences,94 67 19 27 Natural Sciences 207
7,49,63,88,207,entomology,Natural Sciences,7 49 63 88 Natural Sciences 207
79,13,91,24,207,entomology,Natural Sciences,79 13 91 24 Natural Sciences 207
37,48,96,26,207,entomology,Natural Sciences,37 48 96 26 Natural Sciences 207
89,19,10,89,207,entomology,Natural Sciences,89 19 10 89 Natural Sciences 207
69,81,26,31,207,entomology,Natural Sciences,69 81 26 31 Natural Sciences 207
51,75,38,43,207,entomology,Natural Sciences,51 75 38 43 Natural Sciences 207
28,48,82,49,207,entomology,Natural Sciences,28 48 82 49 Natural Sciences 207
21,50,50,86,207,entomology,Natural Sciences,21 50 50 86 Natural Sciences 207
26,69,86,26,207,entomology,Natural Sciences,26 69 86 26 Natural Sciences 207
39,50,84,34,207,entomology,Natural Sciences,39 50 84 34 Natural Sciences 207
62,33,16,96,207,entomology,Natural Sciences,62 33 16 96 Natural Sciences 207
52,63,73,19,207,entomology,Natural Sciences,52 63 73 19 Natural Sciences 207
99,14,94,0,207,entomology,Natural Sciences,99 14 94 0 Natural Sciences 207
66,53,60,28,207,entomology,Natural Sciences,66 53 60 28 Natural Sciences 207
62,67,53,25,207,entomology,Natural Sciences,62 67 53 25 Natural Sciences 207
91,4,94,18,207,entomology,Natural Sciences,91 4 94 18 Natural Sciences 207
62,43,64,38,207,entomology,Natural Sciences,62 43 64 38 Natural Sciences 207
56,31,28,92,207,entomology,Natural Sciences,56 31 28 92 Natural Sciences 207
15,62,58,72,207,entomology,Natural Sciences,15 62 58 72 Natural Sciences 207
30,90,1,86,207,entomology,Natural Sciences,30 90 1 86 Natural Sciences 207
72,40,16,79,207,entomology,Natural Sciences,72 40 16 79 Natural Sciences 207
33,62,37,75,207,entomology,Natural Sciences,33 62 37 75 Natural Sciences 207
7,82,60,58,207,entomology,Natural Sciences,7 82 60 58 Natural Sciences 207
3,46,98,60,207,entomology,Natural Sciences,3 46 98 60 Natural Sciences 207
45,37,91,34,207,entomology,Natural Sciences,45 37 91 34 Natural Sciences 207
37,29,66,75,207,entomology,Natural Sciences,37 29 66 75 Natural Sciences 207
49,47,21,91,208,entomology,Natural Sciences,49 47 21 91 Natural Sciences 208
69,13,94,32,208,entomology,Natural Sciences,69 13 94 32 Natural Sciences 208
12,51,46,99,208,entomology,Natural Sciences,12 51 46 99 Natural Sciences 208
69,89,46,4,208,entomology,Natural Sciences,69 89 46 4 Natural Sciences 208
38,45,46,79,208,entomology,Natural Sciences,38 45 46 79 Natural Sciences 208
47,79,61,21,208,entomology,Natural Sciences,47 79 61 21 Natural Sciences 208
8,88,24,88,208,entomology,Natural Sciences,8 88 24 88 Natural Sciences 208
97,15,95,1,208,entomology,Natural Sciences,97 15 95 1 Natural Sciences 208
99,17,75,17,208,entomology,Natural Sciences,99 17 75 17 Natural Sciences 208
33,45,32,98,208,entomology,Natural Sciences,33 45 32 98 Natural Sciences 208
88,52,67,1,208,entomology,Natural Sciences,88 52 67 1 Natural Sciences 208
42,87,61,18,208,entomology,Natural Sciences,42 87 61 18 Natural Sciences 208
86,10,52,60,208,entomology,Natural Sciences,86 10 52 60 Natural Sciences 208
56,35,58,59,208,entomology,Natural Sciences,56 35 58 59 Natural Sciences 208
56,32,38,82,208,entomology,Natural Sciences,56 32 38 82 Natural Sciences 208
54,4,75,75,208,entomology,Natural Sciences,54 4 75 75 Natural Sciences 208
58,84,41,25,208,entomology,Natural Sciences,58 84 41 25 Natural Sciences 208
20,67,90,31,208,entomology,Natural Sciences,20 67 90 31 Natural Sciences 208
35,72,81,20,208,entomology,Natural Sciences,35 72 81 20 Natural Sciences 208
66,67,52,23,208,entomology,Natural Sciences,66 67 52 23 Natural Sciences 208
38,94,62,14,208,entomology,Natural Sciences,38 94 62 14 Natural Sciences 208
76,15,41,76,208,entomology,Natural Sciences,76 15 41 76 Natural Sciences 208
44,48,79,37,208,entomology,Natural Sciences,44 48 79 37 Natural Sciences 208
38,48,60,62,208,entomology,Natural Sciences,38 48 60 62 Natural Sciences 208
82,40,49,37,208,entomology,Natural Sciences,82 40 49 37 Natural Sciences 208
44,91,62,11,208,entomology,Natural Sciences,44 91 62 11 Natural Sciences 208
17,57,69,65,208,entomology,Natural Sciences,17 57 69 65 Natural Sciences 208
66,36,62,44,208,entomology,Natural Sciences,66 36 62 44 Natural Sciences 208
62,46,95,5,208,entomology,Natural Sciences,62 46 95 5 Natural Sciences 208
89,86,15,18,208,entomology,Natural Sciences,89 86 15 18 Natural Sciences 208
72,50,23,63,208,entomology,Natural Sciences,72 50 23 63 Natural Sciences 208
34,39,62,73,208,entomology,Natural Sciences,34 39 62 73 Natural Sciences 208
30,72,43,63,208,entomology,Natural Sciences,30 72 43 63 Natural Sciences 208
64,43,56,45,208,entomology,Natural Sciences,64 43 56 45 Natural Sciences 208
16,96,11,85,208,entomology,Natural Sciences,16 96 11 85 Natural Sciences 208
10,57,78,63,208,entomology,Natural Sciences,10 57 78 63 Natural Sciences 208
46,70,73,20,209,entomology,Natural Sciences,46 70 73 20 Natural Sciences 209
43,23,51,92,209,entomology,Natural Sciences,43 23 51 92 Natural Sciences 209
79,33,80,17,209,entomology,Natural Sciences,79 33 80 17 Natural Sciences 209
99,10,9,91,209,entomology,Natural Sciences,99 10 9 91 Natural Sciences 209
15,69,35,90,209,entomology,Natural Sciences,15 69 35 90 Natural Sciences 209
44,97,28,40,209,entomology,Natural Sciences,44 97 28 40 Natural Sciences 209
65,86,43,15,209,entomology,Natural Sciences,65 86 43 15 Natural Sciences 209
93,28,74,14,209,entomology,Natural Sciences,93 28 74 14 Natural Sciences 209
88,14,39,68,209,entomology,Natural Sciences,88 14 39 68 Natural Sciences 209
35,28,47,99,209,entomology,Natural Sciences,35 28 47 99 Natural Sciences 209
79,42,71,17,209,entomology,Natural Sciences,79 42 71 17 Natural Sciences 209
60,43,13,93,209,entomology,Natural Sciences,60 43 13 93 Natural Sciences 209
17,85,29,78,209,entomology,Natural Sciences,17 85 29 78 Natural Sciences 209
84,16,73,36,209,entomology,Natural Sciences,84 16 73 36 Natural Sciences 209
69,47,47,46,209,entomology,Natural Sciences,69 47 47 46 Natural Sciences 209
68,38,50,53,209,entomology,Natural Sciences,68 38 50 53 Natural Sciences 209
88,83,9,29,209,entomology,Natural Sciences,88 83 9 29 Natural Sciences 209
42,48,70,49,209,entomology,Natural Sciences,42 48 70 49 Natural Sciences 209
92,18,14,85,209,entomology,Natural Sciences,92 18 14 85 Natural Sciences 209
27,60,87,35,209,entomology,Natural Sciences,27 60 87 35 Natural Sciences 209
85,50,74,0,209,entomology,Natural Sciences,85 50 74 0 Natural Sciences 209
48,50,73,38,209,entomology,Natural Sciences,48 50 73 38 Natural Sciences 209
89,99,9,12,209,entomology,Natural Sciences,89 99 9 12 Natural Sciences 209
51,50,50,58,209,entomology,Natural Sciences,51 50 50 58 Natural Sciences 209
99,5,35,70,209,entomology,Natural Sciences,99 5 35 70 Natural Sciences 209
95,7,63,44,209,entomology,Natural Sciences,95 7 63 44 Natural Sciences 209
39,2,81,87,209,entomology,Natural Sciences,39 2 81 87 Natural Sciences 209
35,43,65,66,209,entomology,Natural Sciences,35 43 65 66 Natural Sciences 209
73,57,56,23,209,entomology,Natural Sciences,73 57 56 23 Natural Sciences 209
47,38,40,84,209,entomology,Natural Sciences,47 38 40 84 Natural Sciences 209
72,22,46,69,209,entomology,Natural Sciences,72 22 46 69 Natural Sciences 209
9,17,97,86,209,entomology,Natural Sciences,9 17 97 86 Natural Sciences 209
49,63,17,80,209,entomology,Natural Sciences,49 63 17 80 Natural Sciences 209
36,92,49,32,209,entomology,Natural Sciences,36 92 49 32 Natural Sciences 209
12,44,95,58,209,entomology,Natural Sciences,12 44 95 58 Natural Sciences 209
60,34,46,69,209,entomology,Natural Sciences,60 34 46 69 Natural Sciences 209
83,97,16,13,209,entomology,Natural Sciences,83 97 16 13 Natural Sciences 209
35,57,34,84,210,entomology,Natural Sciences,35 57 34 84 Natural Sciences 210
41,78,76,15,210,entomology,Natural Sciences,41 78 76 15 Natural Sciences 210
84,95,14,17,210,entomology,Natural Sciences,84 95 14 17 Natural Sciences 210
98,7,19,86,210,entomology,Natural Sciences,98 7 19 86 Natural Sciences 210
17,99,0,94,210,entomology,Natural Sciences,17 99 0 94 Natural Sciences 210
77,40,24,69,210,entomology,Natural Sciences,77 40 24 69 Natural Sciences 210
41,61,45,63,210,entomology,Natural Sciences,41 61 45 63 Natural Sciences 210
41,72,54,43,210,entomology,Natural Sciences,41 72 54 43 Natural Sciences 210
40,82,52,36,210,entomology,Natural Sciences,40 82 52 36 Natural Sciences 210
80,48,0,82,210,entomology,Natural Sciences,80 48 0 82 Natural Sciences 210
89,19,29,73,210,entomology,Natural Sciences,89 19 29 73 Natural Sciences 210
24,82,74,30,210,entomology,Natural Sciences,24 82 74 30 Natural Sciences 210
61,36,43,70,210,entomology,Natural Sciences,61 36 43 70 Natural Sciences 210
73,24,22,91,210,entomology,Natural Sciences,73 24 22 91 Natural Sciences 210
45,63,12,90,210,entomology,Natural Sciences,45 63 12 90 Natural Sciences 210
37,84,77,12,210,entomology,Natural Sciences,37 84 77 12 Natural Sciences 210
70,22,55,63,210,entomology,Natural Sciences,70 22 55 63 Natural Sciences 210
61,63,49,37,210,entomology,Natural Sciences,61 63 49 37 Natural Sciences 210
36,66,45,63,210,entomology,Natural Sciences,36 66 45 63 Natural Sciences 210
48,53,40,69,210,entomology,Natural Sciences,48 53 40 69 Natural Sciences 210
88,18,23,81,210,entomology,Natural Sciences,88 18 23 81 Natural Sciences 210
20,8,88,94,210,entomology,Natural Sciences,20 8 88 94 Natural Sciences 210
41,8,99,62,210,entomology,Natural Sciences,41 8 99 62 Natural Sciences 210
73,19,62,56,210,entomology,Natural Sciences,73 19 62 56 Natural Sciences 210
37,16,84,73,210,entomology,Natural Sciences,37 16 84 73 Natural Sciences 210
54,47,33,76,210,entomology,Natural Sciences,54 47 33 76 Natural Sciences 210
77,80,27,26,210,entomology,Natural Sciences,77 80 27 26 Natural Sciences 210
20,85,36,69,210,entomology,Natural Sciences,20 85 36 69 Natural Sciences 210
58,22,52,78,210,entomology,Natural Sciences,58 22 52 78 Natural Sciences 210
41,90,72,7,210,entomology,Natural Sciences,41 90 72 7 Natural Sciences 210
71,50,39,50,210,entomology,Natural Sciences,71 50 39 50 Natural Sciences 210
92,31,61,27,211,mycology and plant pathology,Natural Sciences,92 31 61 27 Natural Sciences 211
62,74,50,25,211,mycology and plant pathology,Natural Sciences,62 74 50 25 Natural Sciences 211
19,78,88,26,211,mycology and plant pathology,Natural Sciences,19 78 88 26 Natural Sciences 211
28,54,32,97,211,mycology and plant pathology,Natural Sciences,28 54 32 97 Natural Sciences 211
30,50,43,88,211,mycology and plant pathology,Natural Sciences,30 50 43 88 Natural Sciences 211
75,27,12,97,211,mycology and plant pathology,Natural Sciences,75 27 12 97 Natural Sciences 211
84,2,84,41,211,mycology and plant pathology,Natural Sciences,84 2 84 41 Natural Sciences 211
36,57,70,48,211,mycology and plant pathology,Natural Sciences,36 57 70 48 Natural Sciences 211
39,94,55,23,211,mycology and plant pathology,Natural Sciences,39 94 55 23 Natural Sciences 211
41,93,65,12,211,mycology and plant pathology,Natural Sciences,41 93 65 12 Natural Sciences 211
67,42,20,82,211,mycology and plant pathology,Natural Sciences,67 42 20 82 Natural Sciences 211
22,35,71,83,211,mycology and plant pathology,Natural Sciences,22 35 71 83 Natural Sciences 211
62,78,8,63,211,mycology and plant pathology,Natural Sciences,62 78 8 63 Natural Sciences 211
94,8,72,37,211,mycology and plant pathology,Natural Sciences,94 8 72 37 Natural Sciences 211
57,70,49,35,211,mycology and plant pathology,Natural Sciences,57 70 49 35 Natural Sciences 211
65,33,67,46,211,mycology and plant pathology,Natural Sciences,65 33 67 46 Natural Sciences 211
34,42,65,70,211,mycology and plant pathology,Natural Sciences,34 42 65 70 Natural Sciences 211
26,51,75,59,211,mycology and plant pathology,Natural Sciences,26 51 75 59 Natural Sciences 211
92,5,76,38,211,mycology and plant pathology,Natural Sciences,92 5 76 38 Natural Sciences 211
18,98,47,48,211,mycology and plant pathology,Natural Sciences,18 98 47 48 Natural Sciences 211
17,75,28,91,211,mycology and plant pathology,Natural Sciences,17 75 28 91 Natural Sciences 211
33,76,54,48,211,mycology and plant pathology,Natural Sciences,33 76 54 48 Natural Sciences 211
34,26,96,55,211,mycology and plant pathology,Natural Sciences,34 26 96 55 Natural Sciences 211
48,73,4,86,211,mycology and plant pathology,Natural Sciences,48 73 4 86 Natural Sciences 211
37,28,95,51,211,mycology and plant pathology,Natural Sciences,37 28 95 51 Natural Sciences 211
88,85,25,13,211,mycology and plant pathology,Natural Sciences,88 85 25 13 Natural Sciences 211
50,1,66,94,211,mycology and plant pathology,Natural Sciences,50 1 66 94 Natural Sciences 211
45,59,62,45,211,mycology and plant pathology,Natural Sciences,45 59 62 45 Natural Sciences 211
71,37,55,48,211,mycology and plant pathology,Natural Sciences,71 37 55 48 Natural Sciences 211
15,35,71,90,211,mycology and plant pathology,Natural Sciences,15 35 71 90 Natural Sciences 211
54,78,22,57,211,mycology and plant pathology,Natural Sciences,54 78 22 57 Natural Sciences 211
16,70,37,88,211,mycology and plant pathology,Natural Sciences,16 70 37 88 Natural Sciences 211
78,26,96,11,211,mycology and plant pathology,Natural Sciences,78 26 96 11 Natural Sciences 211
23,37,52,99,211,mycology and plant pathology,Natural Sciences,23 37 52 99 Natural Sciences 211
59,48,38,66,211,mycology and plant pathology,Natural Sciences,59 48 38 66 Natural Sciences 211
56,50,55,50,211,mycology and plant pathology,Natural Sciences,56 50 55 50 Natural Sciences 211
55,78,54,24,211,mycology and plant pathology,Natural Sciences,55 78 54 24 Natural Sciences 211
58,29,80,45,212,mycology and plant pathology,Natural Sciences,58 29 80 45 Natural Sciences 212
67,50,88,7,212,mycology and plant pathology,Natural Sciences,67 50 88 7 Natural Sciences 212
33,63,28,88,212,mycology and plant pathology,Natural Sciences,33 63 28 88 Natural Sciences 212
53,61,20,78,212,mycology and plant pathology,Natural Sciences,53 61 20 78 Natural Sciences 212
71,54,83,4,212,mycology and plant pathology,Natural Sciences,71 54 83 4 Natural Sciences 212
86,57,48,21,212,mycology and plant pathology,Natural Sciences,86 57 48 21 Natural Sciences 212
86,37,86,3,212,mycology and plant pathology,Natural Sciences,86 37 86 3 Natural Sciences 212
49,74,55,34,212,mycology and plant pathology,Natural Sciences,49 74 55 34 Natural Sciences 212
47,10,56,99,212,mycology and plant pathology,Natural Sciences,47 10 56 99 Natural Sciences 212
98,29,47,38,212,mycology and plant pathology,Natural Sciences,98 29 47 38 Natural Sciences 212
76,8,91,37,212,mycology and plant pathology,Natural Sciences,76 8 91 37 Natural Sciences 212
39,56,30,87,212,mycology and plant pathology,Natural Sciences,39 56 30 87 Natural Sciences 212
44,65,29,74,212,mycology and plant pathology,Natural Sciences,44 65 29 74 Natural Sciences 212
37,57,71,47,212,mycology and plant pathology,Natural Sciences,37 57 71 47 Natural Sciences 212
67,15,48,82,212,mycology and plant pathology,Natural Sciences,67 15 48 82 Natural Sciences 212
36,89,43,44,212,mycology and plant pathology,Natural Sciences,36 89 43 44 Natural Sciences 212
34,18,79,81,212,mycology and plant pathology,Natural Sciences,34 18 79 81 Natural Sciences 212
46,60,69,37,212,mycology and plant pathology,Natural Sciences,46 60 69 37 Natural Sciences 212
30,92,62,28,212,mycology and plant pathology,Natural Sciences,30 92 62 28 Natural Sciences 212
28,61,40,83,212,mycology and plant pathology,Natural Sciences,28 61 40 83 Natural Sciences 212
68,76,43,25,212,mycology and plant pathology,Natural Sciences,68 76 43 25 Natural Sciences 212
88,25,33,66,212,mycology and plant pathology,Natural Sciences,88 25 33 66 Natural Sciences 212
96,28,61,27,212,mycology and plant pathology,Natural Sciences,96 28 61 27 Natural Sciences 212
60,80,19,53,212,mycology and plant pathology,Natural Sciences,60 80 19 53 Natural Sciences 212
87,12,67,46,212,mycology and plant pathology,Natural Sciences,87 12 67 46 Natural Sciences 212
30,83,39,60,212,mycology and plant pathology,Natural Sciences,30 83 39 60 Natural Sciences 212
60,46,39,67,212,mycology and plant pathology,Natural Sciences,60 46 39 67 Natural Sciences 212
77,36,5,94,212,mycology and plant pathology,Natural Sciences,77 36 5 94 Natural Sciences 212
68,85,43,16,212,mycology and plant pathology,Natural Sciences,68 85 43 16 Natural Sciences 212
52,44,48,68,212,mycology and plant pathology,Natural Sciences,52 44 48 68 Natural Sciences 212
49,11,87,65,212,mycology and plant pathology,Natural Sciences,49 11 87 65 Natural Sciences 212
4,15,96,97,212,mycology and plant pathology,Natural Sciences,4 15 96 97 Natural Sciences 212
28,66,37,81,212,mycology and plant pathology,Natural Sciences,28 66 37 81 Natural Sciences 212
35,50,77,50,212,mycology and plant pathology,Natural Sciences,35 50 77 50 Natural Sciences 212
44,80,68,20,212,mycology and plant pathology,Natural Sciences,44 80 68 20 Natural Sciences 212
20,79,31,82,212,mycology and plant pathology,Natural Sciences,20 79 31 82 Natural Sciences 212
90,6,25,91,212,mycology and plant pathology,Natural Sciences,90 6 25 91 Natural Sciences 212
0,59,55,98,212,mycology and plant pathology,Natural Sciences,0 59 55 98 Natural Sciences 212
81,25,95,11,212,mycology and plant pathology,Natural Sciences,81 25 95 11 Natural Sciences 212
99,7,41,65,212,mycology and plant pathology,Natural Sciences,99 7 41 65 Natural Sciences 212
64,39,15,94,212,mycology and plant pathology,Natural Sciences,64 39 15 94 Natural Sciences 212
57,61,16,78,212,mycology and plant pathology,Natural Sciences,57 61 16 78 Natural Sciences 212
42,75,80,15,212,mycology and plant pathology,Natural Sciences,42 75 80 15 Natural Sciences 212
56,32,54,70,212,mycology and plant pathology,Natural Sciences,56 32 54 70 Natural Sciences 212
89,25,36,63,213,mycology and plant pathology,Natural Sciences,89 25 36 63 Natural Sciences 213
33,12,94,74,213,mycology and plant pathology,Natural Sciences,33 12 94 74 Natural Sciences 213
97,90,10,16,213,mycology and plant pathology,Natural Sciences,97 90 10 16 Natural Sciences 213
33,92,63,25,213,mycology and plant pathology,Natural Sciences,33 92 63 25 Natural Sciences 213
63,47,89,14,213,mycology and plant pathology,Natural Sciences,63 47 89 14 Natural Sciences 213
90,34,28,61,213,mycology and plant pathology,Natural Sciences,90 34 28 61 Natural Sciences 213
74,16,49,74,213,mycology and plant pathology,Natural Sciences,74 16 49 74 Natural Sciences 213
42,70,65,36,213,mycology and plant pathology,Natural Sciences,42 70 65 36 Natural Sciences 213
93,33,53,34,213,mycology and plant pathology,Natural Sciences,93 33 53 34 Natural Sciences 213
13,95,24,81,213,mycology and plant pathology,Natural Sciences,13 95 24 81 Natural Sciences 213
95,48,61,9,213,mycology and plant pathology,Natural Sciences,95 48 61 9 Natural Sciences 213
36,34,89,54,213,mycology and plant pathology,Natural Sciences,36 34 89 54 Natural Sciences 213
7,65,57,84,213,mycology and plant pathology,Natural Sciences,7 65 57 84 Natural Sciences 213
59,13,57,84,213,mycology and plant pathology,Natural Sciences,59 13 57 84 Natural Sciences 213
88,5,25,95,213,mycology and plant pathology,Natural Sciences,88 5 25 95 Natural Sciences 213
84,43,85,1,213,mycology and plant pathology,Natural Sciences,84 43 85 1 Natural Sciences 213
75,43,43,52,213,mycology and plant pathology,Natural Sciences,75 43 43 52 Natural Sciences 213
26,95,73,19,213,mycology and plant pathology,Natural Sciences,26 95 73 19 Natural Sciences 213
64,56,16,77,213,mycology and plant pathology,Natural Sciences,64 56 16 77 Natural Sciences 213
90,18,85,20,213,mycology and plant pathology,Natural Sciences,90 18 85 20 Natural Sciences 213
43,95,61,14,213,mycology and plant pathology,Natural Sciences,43 95 61 14 Natural Sciences 213
82,12,77,42,213,mycology and plant pathology,Natural Sciences,82 12 77 42 Natural Sciences 213
27,89,36,61,213,mycology and plant pathology,Natural Sciences,27 89 36 61 Natural Sciences 213
99,6,13,95,213,mycology and plant pathology,Natural Sciences,99 6 13 95 Natural Sciences 213
89,33,22,69,213,mycology and plant pathology,Natural Sciences,89 33 22 69 Natural Sciences 213
99,3,84,27,213,mycology and plant pathology,Natural Sciences,99 3 84 27 Natural Sciences 213
72,23,49,69,213,mycology and plant pathology,Natural Sciences,72 23 49 69 Natural Sciences 213
50,50,66,47,213,mycology and plant pathology,Natural Sciences,50 50 66 47 Natural Sciences 213
56,78,6,73,213,mycology and plant pathology,Natural Sciences,56 78 6 73 Natural Sciences 213
80,38,79,16,213,mycology and plant pathology,Natural Sciences,80 38 79 16 Natural Sciences 213
10,84,40,79,213,mycology and plant pathology,Natural Sciences,10 84 40 79 Natural Sciences 213
17,90,44,62,213,mycology and plant pathology,Natural Sciences,17 90 44 62 Natural Sciences 213
10,70,71,63,214,mycology and plant pathology,Natural Sciences,10 70 71 63 Natural Sciences 214
73,13,77,51,214,mycology and plant pathology,Natural Sciences,73 13 77 51 Natural Sciences 214
83,23,73,35,214,mycology and plant pathology,Natural Sciences,83 23 73 35 Natural Sciences 214
65,43,95,11,214,mycology and plant pathology,Natural Sciences,65 43 95 11 Natural Sciences 214
78,36,50,50,214,mycology and plant pathology,Natural Sciences,78 36 50 50 Natural Sciences 214
72,33,39,70,214,mycology and plant pathology,Natural Sciences,72 33 39 70 Natural Sciences 214
55,75,56,28,214,mycology and plant pathology,Natural Sciences,55 75 56 28 Natural Sciences 214
68,26,79,41,214,mycology and plant pathology,Natural Sciences,68 26 79 41 Natural Sciences 214
21,65,98,30,214,mycology and plant pathology,Natural Sciences,21 65 98 30 Natural Sciences 214
99,25,59,31,214,mycology and plant pathology,Natural Sciences,99 25 59 31 Natural Sciences 214
47,47,58,62,214,mycology and plant pathology,Natural Sciences,47 47 58 62 Natural Sciences 214
31,73,80,30,214,mycology and plant pathology,Natural Sciences,31 73 80 30 Natural Sciences 214
80,20,74,40,214,mycology and plant pathology,Natural Sciences,80 20 74 40 Natural Sciences 214
10,28,89,87,214,mycology and plant pathology,Natural Sciences,10 28 89 87 Natural Sciences 214
64,80,16,54,214,mycology and plant pathology,Natural Sciences,64 80 16 54 Natural Sciences 214
71,24,94,25,214,mycology and plant pathology,Natural Sciences,71 24 94 25 Natural Sciences 214
41,60,89,24,214,mycology and plant pathology,Natural Sciences,41 60 89 24 Natural Sciences 214
69,53,5,87,214,mycology and plant pathology,Natural Sciences,69 53 5 87 Natural Sciences 214
82,32,20,80,214,mycology and plant pathology,Natural Sciences,82 32 20 80 Natural Sciences 214
48,41,54,71,214,mycology and plant pathology,Natural Sciences,48 41 54 71 Natural Sciences 214
29,82,68,35,214,mycology and plant pathology,Natural Sciences,29 82 68 35 Natural Sciences 214
47,55,50,62,214,mycology and plant pathology,Natural Sciences,47 55 50 62 Natural Sciences 214
56,66,22,70,214,mycology and plant pathology,Natural Sciences,56 66 22 70 Natural Sciences 214
50,93,61,10,214,mycology and plant pathology,Natural Sciences,50 93 61 10 Natural Sciences 214
29,30,71,84,214,mycology and plant pathology,Natural Sciences,29 30 71 84 Natural Sciences 214
35,67,96,16,214,mycology and plant pathology,Natural Sciences,35 67 96 16 Natural Sciences 214
82,52,59,21,214,mycology and plant pathology,Natural Sciences,82 52 59 21 Natural Sciences 214
57,66,18,73,214,mycology and plant pathology,Natural Sciences,57 66 18 73 Natural Sciences 214
57,48,36,73,214,mycology and plant pathology,Natural Sciences,57 48 36 73 Natural Sciences 214
52,62,94,6,214,mycology and plant pathology,Natural Sciences,52 62 94 6 Natural Sciences 214
17,42,80,75,214,mycology and plant pathology,Natural Sciences,17 42 80 75 Natural Sciences 214
12,98,51,53,214,mycology and plant pathology,Natural Sciences,12 98 51 53 Natural Sciences 214
41,99,21,53,214,mycology and plant pathology,Natural Sciences,41 99 21 53 Natural Sciences 214
23,69,81,41,214,mycology and plant pathology,Natural Sciences,23 69 81 41 Natural Sciences 214
5,49,64,96,214,mycology and plant pathology,Natural Sciences,5 49 64 96 Natural Sciences 214
99,14,7,94,214,mycology and plant pathology,Natural Sciences,99 14 7 94 Natural Sciences 214
53,100,14,47,214,mycology and plant pathology,Natural Sciences,53 100 14 47 Natural Sciences 214
47,35,40,92,214,mycology and plant pathology,Natural Sciences,47 35 40 92 Natural Sciences 214
70,30,63,51,214,mycology and plant pathology,Natural Sciences,70 30 63 51 Natural Sciences 214
89,1,48,76,214,mycology and plant pathology,Natural Sciences,89 1 48 76 Natural Sciences 214
84,39,51,40,214,mycology and plant pathology,Natural Sciences,84 39 51 40 Natural Sciences 214
39,28,80,68,215,mycology and plant pathology,Natural Sciences,39 28 80 68 Natural Sciences 215
45,19,56,95,215,mycology and plant pathology,Natural Sciences,45 19 56 95 Natural Sciences 215
49,46,32,88,215,mycology and plant pathology,Natural Sciences,49 46 32 88 Natural Sciences 215
59,39,55,62,215,mycology and plant pathology,Natural Sciences,59 39 55 62 Natural Sciences 215
23,34,90,68,215,mycology and plant pathology,Natural Sciences,23 34 90 68 Natural Sciences 215
70,29,80,36,215,mycology and plant pathology,Natural Sciences,70 29 80 36 Natural Sciences 215
72,32,46,65,215,mycology and plant pathology,Natural Sciences,72 32 46 65 Natural Sciences 215
67,10,39,99,215,mycology and plant pathology,Natural Sciences,67 10 39 99 Natural Sciences 215
87,23,49,56,215,mycology and plant pathology,Natural Sciences,87 23 49 56 Natural Sciences 215
92,6,18,99,215,mycology and plant pathology,Natural Sciences,92 6 18 99 Natural Sciences 215
44,61,15,95,215,mycology and plant pathology,Natural Sciences,44 61 15 95 Natural Sciences 215
16,53,76,70,215,mycology and plant pathology,Natural Sciences,16 53 76 70 Natural Sciences 215
50,33,78,54,215,mycology and plant pathology,Natural Sciences,50 33 78 54 Natural Sciences 215
66,52,52,45,215,mycology and plant pathology,Natural Sciences,66 52 52 45 Natural Sciences 215
49,86,18,62,215,mycology and plant pathology,Natural Sciences,49 86 18 62 Natural Sciences 215
67,50,90,8,215,mycology and plant pathology,Natural Sciences,67 50 90 8 Natural Sciences 215
22,23,85,85,215,mycology and plant pathology,Natural Sciences,22 23 85 85 Natural Sciences 215
96,78,31,10,215,mycology and plant pathology,Natural Sciences,96 78 31 10 Natural Sciences 215
82,37,86,10,215,mycology and plant pathology,Natural Sciences,82 37 86 10 Natural Sciences 215
91,21,18,85,215,mycology and plant pathology,Natural Sciences,91 21 18 85 Natural Sciences 215
68,40,76,31,215,mycology and plant pathology,Natural Sciences,68 40 76 31 Natural Sciences 215
60,68,0,87,215,mycology and plant pathology,Natural Sciences,60 68 0 87 Natural Sciences 215
40,56,62,57,215,mycology and plant pathology,Natural Sciences,40 56 62 57 Natural Sciences 215
93,50,70,2,215,mycology and plant pathology,Natural Sciences,93 50 70 2 Natural Sciences 215
28,36,63,88,215,mycology and plant pathology,Natural Sciences,28 36 63 88 Natural Sciences 215
19,50,64,82,215,mycology and plant pathology,Natural Sciences,19 50 64 82 Natural Sciences 215
71,18,52,74,215,mycology and plant pathology,Natural Sciences,71 18 52 74 Natural Sciences 215
56,55,73,31,215,mycology and plant pathology,Natural Sciences,56 55 73 31 Natural Sciences 215
76,25,34,80,215,mycology and plant pathology,Natural Sciences,76 25 34 80 Natural Sciences 215
35,86,52,42,215,mycology and plant pathology,Natural Sciences,35 86 52 42 Natural Sciences 215
45,86,20,64,215,mycology and plant pathology,Natural Sciences,45 86 20 64 Natural Sciences 215
38,80,31,66,215,mycology and plant pathology,Natural Sciences,38 80 31 66 Natural Sciences 215
51,73,15,76,215,mycology and plant pathology,Natural Sciences,51 73 15 76 Natural Sciences 215
20,95,95,5,215,mycology and plant pathology,Natural Sciences,20 95 95 5 Natural Sciences 215
20,83,65,47,215,mycology and plant pathology,Natural Sciences,20 83 65 47 Natural Sciences 215
58,80,27,50,215,mycology and plant pathology,Natural Sciences,58 80 27 50 Natural Sciences 215
58,86,21,50,215,mycology and plant pathology,Natural Sciences,58 86 21 50 Natural Sciences 215
61,30,28,96,215,mycology and plant pathology,Natural Sciences,61 30 28 96 Natural Sciences 215
98,32,54,31,215,mycology and plant pathology,Natural Sciences,98 32 54 31 Natural Sciences 215
53,39,60,63,215,mycology and plant pathology,Natural Sciences,53 39 60 63 Natural Sciences 215
95,31,17,72,215,mycology and plant pathology,Natural Sciences,95 31 17 72 Natural Sciences 215
38,65,60,52,215,mycology and plant pathology,Natural Sciences,38 65 60 52 Natural Sciences 215
70,26,58,61,215,mycology and plant pathology,Natural Sciences,70 26 58 61 Natural Sciences 215
37,43,72,63,215,mycology and plant pathology,Natural Sciences,37 43 72 63 Natural Sciences 215
60,41,82,32,215,mycology and plant pathology,Natural Sciences,60 41 82 32 Natural Sciences 215
43,77,50,45,215,mycology and plant pathology,Natural Sciences,43 77 50 45 Natural Sciences 215
45,43,62,65,215,mycology and plant pathology,Natural Sciences,45 43 62 65 Natural Sciences 215
69,39,78,29,215,mycology and plant pathology,Natural Sciences,69 39 78 29 Natural Sciences 215
35,46,94,40,215,mycology and plant pathology,Natural Sciences,35 46 94 40 Natural Sciences 215
98,7,51,59,215,mycology and plant pathology,Natural Sciences,98 7 51 59 Natural Sciences 215
33,34,84,64,215,mycology and plant pathology,Natural Sciences,33 34 84 64 Natural Sciences 215
79,85,35,16,215,mycology and plant pathology,Natural Sciences,79 85 35 16 Natural Sciences 215
34,81,97,3,215,mycology and plant pathology,Natural Sciences,34 81 97 3 Natural Sciences 215
63,63,62,28,216,oncology nursing,Nursing Sciences,63 63 62 28 Nursing Sciences 216
10,54,74,78,216,oncology nursing,Nursing Sciences,10 54 74 78 Nursing Sciences 216
38,46,80,52,216,oncology nursing,Nursing Sciences,38 46 80 52 Nursing Sciences 216
11,50,78,77,216,oncology nursing,Nursing Sciences,11 50 78 77 Nursing Sciences 216
69,72,28,47,216,oncology nursing,Nursing Sciences,69 72 28 47 Nursing Sciences 216
18,90,10,98,216,oncology nursing,Nursing Sciences,18 90 10 98 Nursing Sciences 216
24,59,96,37,216,oncology nursing,Nursing Sciences,24 59 96 37 Nursing Sciences 216
73,23,27,93,216,oncology nursing,Nursing Sciences,73 23 27 93 Nursing Sciences 216
30,49,53,84,216,oncology nursing,Nursing Sciences,30 49 53 84 Nursing Sciences 216
96,11,72,37,216,oncology nursing,Nursing Sciences,96 11 72 37 Nursing Sciences 216
32,48,70,66,216,oncology nursing,Nursing Sciences,32 48 70 66 Nursing Sciences 216
50,72,20,74,216,oncology nursing,Nursing Sciences,50 72 20 74 Nursing Sciences 216
49,26,70,71,216,oncology nursing,Nursing Sciences,49 26 70 71 Nursing Sciences 216
25,43,87,61,216,oncology nursing,Nursing Sciences,25 43 87 61 Nursing Sciences 216
99,2,72,43,216,oncology nursing,Nursing Sciences,99 2 72 43 Nursing Sciences 216
55,76,65,20,216,oncology nursing,Nursing Sciences,55 76 65 20 Nursing Sciences 216
66,65,15,70,216,oncology nursing,Nursing Sciences,66 65 15 70 Nursing Sciences 216
96,6,87,27,216,oncology nursing,Nursing Sciences,96 6 87 27 Nursing Sciences 216
21,27,85,83,216,oncology nursing,Nursing Sciences,21 27 85 83 Nursing Sciences 216
15,71,57,73,216,oncology nursing,Nursing Sciences,15 71 57 73 Nursing Sciences 216
62,68,60,26,216,oncology nursing,Nursing Sciences,62 68 60 26 Nursing Sciences 216
44,76,72,24,216,oncology nursing,Nursing Sciences,44 76 72 24 Nursing Sciences 216
99,39,26,52,216,oncology nursing,Nursing Sciences,99 39 26 52 Nursing Sciences 216
32,75,75,34,216,oncology nursing,Nursing Sciences,32 75 75 34 Nursing Sciences 216
88,26,71,31,216,oncology nursing,Nursing Sciences,88 26 71 31 Nursing Sciences 216
64,59,73,20,216,oncology nursing,Nursing Sciences,64 59 73 20 Nursing Sciences 216
68,89,16,43,216,oncology nursing,Nursing Sciences,68 89 16 43 Nursing Sciences 216
48,94,44,30,216,oncology nursing,Nursing Sciences,48 94 44 30 Nursing Sciences 216
90,39,72,15,216,oncology nursing,Nursing Sciences,90 39 72 15 Nursing Sciences 216
28,95,13,80,216,oncology nursing,Nursing Sciences,28 95 13 80 Nursing Sciences 216
62,31,59,64,216,oncology nursing,Nursing Sciences,62 31 59 64 Nursing Sciences 216
83,61,43,29,216,oncology nursing,Nursing Sciences,83 61 43 29 Nursing Sciences 216
53,60,73,30,216,oncology nursing,Nursing Sciences,53 60 73 30 Nursing Sciences 216
26,88,40,62,216,oncology nursing,Nursing Sciences,26 88 40 62 Nursing Sciences 216
83,8,53,72,216,oncology nursing,Nursing Sciences,83 8 53 72 Nursing Sciences 216
100,11,11,94,216,oncology nursing,Nursing Sciences,100 11 11 94 Nursing Sciences 216
78,48,24,66,216,oncology nursing,Nursing Sciences,78 48 24 66 Nursing Sciences 216
50,79,9,78,216,oncology nursing,Nursing Sciences,50 79 9 78 Nursing Sciences 216
8,38,79,91,216,oncology nursing,Nursing Sciences,8 38 79 91 Nursing Sciences 216
16,56,54,90,216,oncology nursing,Nursing Sciences,16 56 54 90 Nursing Sciences 216
14,49,67,86,216,oncology nursing,Nursing Sciences,14 49 67 86 Nursing Sciences 216
54,74,44,44,216,oncology nursing,Nursing Sciences,54 74 44 44 Nursing Sciences 216
50,57,72,38,217,oncology nursing,Nursing Sciences,50 57 72 38 Nursing Sciences 217
39,80,77,21,217,oncology nursing,Nursing Sciences,39 80 77 21 Nursing Sciences 217
87,33,59,38,217,oncology nursing,Nursing Sciences,87 33 59 38 Nursing Sciences 217
71,65,59,22,217,oncology nursing,Nursing Sciences,71 65 59 22 Nursing Sciences 217
28,36,67,86,217,oncology nursing,Nursing Sciences,28 36 67 86 Nursing Sciences 217
94,88,8,27,217,oncology nursing,Nursing Sciences,94 88 8 27 Nursing Sciences 217
89,17,52,59,217,oncology nursing,Nursing Sciences,89 17 52 59 Nursing Sciences 217
95,30,77,15,217,oncology nursing,Nursing Sciences,95 30 77 15 Nursing Sciences 217
84,64,20,49,217,oncology nursing,Nursing Sciences,84 64 20 49 Nursing Sciences 217
44,51,27,95,217,oncology nursing,Nursing Sciences,44 51 27 95 Nursing Sciences 217
50,84,18,65,217,oncology nursing,Nursing Sciences,50 84 18 65 Nursing Sciences 217
78,28,44,67,217,oncology nursing,Nursing Sciences,78 28 44 67 Nursing Sciences 217
80,40,17,80,217,oncology nursing,Nursing Sciences,80 40 17 80 Nursing Sciences 217
79,13,31,94,217,oncology nursing,Nursing Sciences,79 13 31 94 Nursing Sciences 217
52,76,42,47,217,oncology nursing,Nursing Sciences,52 76 42 47 Nursing Sciences 217
98,24,89,6,217,oncology nursing,Nursing Sciences,98 24 89 6 Nursing Sciences 217
70,8,41,98,217,oncology nursing,Nursing Sciences,70 8 41 98 Nursing Sciences 217
93,19,54,51,217,oncology nursing,Nursing Sciences,93 19 54 51 Nursing Sciences 217
33,39,51,94,217,oncology nursing,Nursing Sciences,33 39 51 94 Nursing Sciences 217
92,50,60,15,217,oncology nursing,Nursing Sciences,92 50 60 15 Nursing Sciences 217
53,56,77,31,217,oncology nursing,Nursing Sciences,53 56 77 31 Nursing Sciences 217
51,55,87,24,217,oncology nursing,Nursing Sciences,51 55 87 24 Nursing Sciences 217
14,73,41,89,217,oncology nursing,Nursing Sciences,14 73 41 89 Nursing Sciences 217
91,35,72,19,217,oncology nursing,Nursing Sciences,91 35 72 19 Nursing Sciences 217
8,39,99,71,217,oncology nursing,Nursing Sciences,8 39 99 71 Nursing Sciences 217
50,10,79,78,217,oncology nursing,Nursing Sciences,50 10 79 78 Nursing Sciences 217
66,31,88,32,217,oncology nursing,Nursing Sciences,66 31 88 32 Nursing Sciences 217
40,20,80,77,217,oncology nursing,Nursing Sciences,40 20 80 77 Nursing Sciences 217
35,54,74,54,217,oncology nursing,Nursing Sciences,35 54 74 54 Nursing Sciences 217
54,91,46,26,217,oncology nursing,Nursing Sciences,54 91 46 26 Nursing Sciences 217
33,78,56,50,217,oncology nursing,Nursing Sciences,33 78 56 50 Nursing Sciences 217
87,42,38,50,217,oncology nursing,Nursing Sciences,87 42 38 50 Nursing Sciences 217
21,50,85,61,217,oncology nursing,Nursing Sciences,21 50 85 61 Nursing Sciences 217
33,73,36,75,217,oncology nursing,Nursing Sciences,33 73 36 75 Nursing Sciences 217
39,86,92,0,217,oncology nursing,Nursing Sciences,39 86 92 0 Nursing Sciences 217
78,17,82,40,217,oncology nursing,Nursing Sciences,78 17 82 40 Nursing Sciences 217
58,1,62,96,217,oncology nursing,Nursing Sciences,58 1 62 96 Nursing Sciences 217
75,47,80,16,218,oncology nursing,Nursing Sciences,75 47 80 16 Nursing Sciences 218
79,50,72,17,218,oncology nursing,Nursing Sciences,79 50 72 17 Nursing Sciences 218
54,52,48,64,218,oncology nursing,Nursing Sciences,54 52 48 64 Nursing Sciences 218
13,87,37,81,218,oncology nursing,Nursing Sciences,13 87 37 81 Nursing Sciences 218
31,39,80,68,218,oncology nursing,Nursing Sciences,31 39 80 68 Nursing Sciences 218
34,53,57,74,218,oncology nursing,Nursing Sciences,34 53 57 74 Nursing Sciences 218
50,79,67,22,218,oncology nursing,Nursing Sciences,50 79 67 22 Nursing Sciences 218
68,59,10,81,218,oncology nursing,Nursing Sciences,68 59 10 81 Nursing Sciences 218
67,34,85,32,218,oncology nursing,Nursing Sciences,67 34 85 32 Nursing Sciences 218
54,26,89,49,218,oncology nursing,Nursing Sciences,54 26 89 49 Nursing Sciences 218
41,87,40,50,218,oncology nursing,Nursing Sciences,41 87 40 50 Nursing Sciences 218
95,0,90,33,218,oncology nursing,Nursing Sciences,95 0 90 33 Nursing Sciences 218
59,8,93,58,218,oncology nursing,Nursing Sciences,59 8 93 58 Nursing Sciences 218
50,32,42,94,218,oncology nursing,Nursing Sciences,50 32 42 94 Nursing Sciences 218
21,73,39,85,218,oncology nursing,Nursing Sciences,21 73 39 85 Nursing Sciences 218
54,66,72,26,218,oncology nursing,Nursing Sciences,54 66 72 26 Nursing Sciences 218
12,88,42,76,218,oncology nursing,Nursing Sciences,12 88 42 76 Nursing Sciences 218
65,82,45,26,218,oncology nursing,Nursing Sciences,65 82 45 26 Nursing Sciences 218
16,84,34,84,218,oncology nursing,Nursing Sciences,16 84 34 84 Nursing Sciences 218
11,92,57,58,218,oncology nursing,Nursing Sciences,11 92 57 58 Nursing Sciences 218
57,70,51,40,218,oncology nursing,Nursing Sciences,57 70 51 40 Nursing Sciences 218
6,95,57,60,218,oncology nursing,Nursing Sciences,6 95 57 60 Nursing Sciences 218
96,9,27,86,218,oncology nursing,Nursing Sciences,96 9 27 86 Nursing Sciences 218
57,54,78,29,218,oncology nursing,Nursing Sciences,57 54 78 29 Nursing Sciences 218
50,62,86,20,218,oncology nursing,Nursing Sciences,50 62 86 20 Nursing Sciences 218
84,65,44,25,218,oncology nursing,Nursing Sciences,84 65 44 25 Nursing Sciences 218
61,96,22,39,218,oncology nursing,Nursing Sciences,61 96 22 39 Nursing Sciences 218
35,97,34,52,218,oncology nursing,Nursing Sciences,35 97 34 52 Nursing Sciences 218
89,45,45,39,218,oncology nursing,Nursing Sciences,89 45 45 39 Nursing Sciences 218
50,50,85,33,218,oncology nursing,Nursing Sciences,50 50 85 33 Nursing Sciences 218
31,45,70,72,218,oncology nursing,Nursing Sciences,31 45 70 72 Nursing Sciences 218
68,19,34,97,218,oncology nursing,Nursing Sciences,68 19 34 97 Nursing Sciences 218
69,23,63,63,218,oncology nursing,Nursing Sciences,69 23 63 63 Nursing Sciences 218
40,18,76,85,219,oncology nursing,Nursing Sciences,40 18 76 85 Nursing Sciences 219
41,25,88,65,219,oncology nursing,Nursing Sciences,41 25 88 65 Nursing Sciences 219
35,21,66,97,219,oncology nursing,Nursing Sciences,35 21 66 97 Nursing Sciences 219
84,20,33,82,219,oncology nursing,Nursing Sciences,84 20 33 82 Nursing Sciences 219
28,65,37,89,219,oncology nursing,Nursing Sciences,28 65 37 89 Nursing Sciences 219
70,60,68,21,219,oncology nursing,Nursing Sciences,70 60 68 21 Nursing Sciences 219
49,80,60,30,219,oncology nursing,Nursing Sciences,49 80 60 30 Nursing Sciences 219
86,64,56,13,219,oncology nursing,Nursing Sciences,86 64 56 13 Nursing Sciences 219
98,5,70,46,219,oncology nursing,Nursing Sciences,98 5 70 46 Nursing Sciences 219
66,95,5,53,219,oncology nursing,Nursing Sciences,66 95 5 53 Nursing Sciences 219
51,92,49,27,219,oncology nursing,Nursing Sciences,51 92 49 27 Nursing Sciences 219
75,7,93,44,219,oncology nursing,Nursing Sciences,75 7 93 44 Nursing Sciences 219
80,76,40,23,219,oncology nursing,Nursing Sciences,80 76 40 23 Nursing Sciences 219
8,64,48,99,219,oncology nursing,Nursing Sciences,8 64 48 99 Nursing Sciences 219
50,6,96,67,219,oncology nursing,Nursing Sciences,50 6 96 67 Nursing Sciences 219
73,43,42,61,219,oncology nursing,Nursing Sciences,73 43 42 61 Nursing Sciences 219
54,77,30,58,219,oncology nursing,Nursing Sciences,54 77 30 58 Nursing Sciences 219
19,41,90,69,219,oncology nursing,Nursing Sciences,19 41 90 69 Nursing Sciences 219
25,27,82,85,219,oncology nursing,Nursing Sciences,25 27 82 85 Nursing Sciences 219
83,9,38,89,219,oncology nursing,Nursing Sciences,83 9 38 89 Nursing Sciences 219
56,86,43,34,219,oncology nursing,Nursing Sciences,56 86 43 34 Nursing Sciences 219
3,55,93,68,219,oncology nursing,Nursing Sciences,3 55 93 68 Nursing Sciences 219
55,97,42,25,219,oncology nursing,Nursing Sciences,55 97 42 25 Nursing Sciences 219
58,84,59,18,219,oncology nursing,Nursing Sciences,58 84 59 18 Nursing Sciences 219
95,80,11,33,219,oncology nursing,Nursing Sciences,95 80 11 33 Nursing Sciences 219
80,11,65,63,219,oncology nursing,Nursing Sciences,80 11 65 63 Nursing Sciences 219
71,28,52,68,219,oncology nursing,Nursing Sciences,71 28 52 68 Nursing Sciences 219
70,60,77,12,219,oncology nursing,Nursing Sciences,70 60 77 12 Nursing Sciences 219
31,74,45,69,219,oncology nursing,Nursing Sciences,31 74 45 69 Nursing Sciences 219
68,69,25,57,219,oncology nursing,Nursing Sciences,68 69 25 57 Nursing Sciences 219
89,46,59,25,219,oncology nursing,Nursing Sciences,89 46 59 25 Nursing Sciences 219
49,61,31,78,219,oncology nursing,Nursing Sciences,49 61 31 78 Nursing Sciences 219
61,75,65,18,219,oncology nursing,Nursing Sciences,61 75 65 18 Nursing Sciences 219
14,77,90,38,219,oncology nursing,Nursing Sciences,14 77 90 38 Nursing Sciences 219
96,26,65,32,219,oncology nursing,Nursing Sciences,96 26 65 32 Nursing Sciences 219
49,16,78,77,220,oncology nursing,Nursing Sciences,49 16 78 77 Nursing Sciences 220
99,12,22,87,220,oncology nursing,Nursing Sciences,99 12 22 87 Nursing Sciences 220
81,25,86,28,220,oncology nursing,Nursing Sciences,81 25 86 28 Nursing Sciences 220
17,94,25,84,220,oncology nursing,Nursing Sciences,17 94 25 84 Nursing Sciences 220
96,29,92,3,220,oncology nursing,Nursing Sciences,96 29 92 3 Nursing Sciences 220
85,91,33,11,220,oncology nursing,Nursing Sciences,85 91 33 11 Nursing Sciences 220
50,79,21,70,220,oncology nursing,Nursing Sciences,50 79 21 70 Nursing Sciences 220
50,34,38,98,220,oncology nursing,Nursing Sciences,50 34 38 98 Nursing Sciences 220
48,42,55,75,220,oncology nursing,Nursing Sciences,48 42 55 75 Nursing Sciences 220
41,29,50,100,220,oncology nursing,Nursing Sciences,41 29 50 100 Nursing Sciences 220
61,17,98,44,220,oncology nursing,Nursing Sciences,61 17 98 44 Nursing Sciences 220
33,22,67,98,220,oncology nursing,Nursing Sciences,33 22 67 98 Nursing Sciences 220
39,90,77,14,220,oncology nursing,Nursing Sciences,39 90 77 14 Nursing Sciences 220
33,55,54,78,220,oncology nursing,Nursing Sciences,33 55 54 78 Nursing Sciences 220
76,68,68,8,220,oncology nursing,Nursing Sciences,76 68 68 8 Nursing Sciences 220
48,93,5,74,220,oncology nursing,Nursing Sciences,48 93 5 74 Nursing Sciences 220
80,43,40,57,220,oncology nursing,Nursing Sciences,80 43 40 57 Nursing Sciences 220
0,95,31,94,220,oncology nursing,Nursing Sciences,0 95 31 94 Nursing Sciences 220
28,27,79,86,220,oncology nursing,Nursing Sciences,28 27 79 86 Nursing Sciences 220
85,26,92,17,220,oncology nursing,Nursing Sciences,85 26 92 17 Nursing Sciences 220
48,36,48,88,220,oncology nursing,Nursing Sciences,48 36 48 88 Nursing Sciences 220
49,56,75,40,220,oncology nursing,Nursing Sciences,49 56 75 40 Nursing Sciences 220
88,11,62,59,220,oncology nursing,Nursing Sciences,88 11 62 59 Nursing Sciences 220
63,55,48,54,220,oncology nursing,Nursing Sciences,63 55 48 54 Nursing Sciences 220
63,94,15,48,220,oncology nursing,Nursing Sciences,63 94 15 48 Nursing Sciences 220
70,85,5,60,220,oncology nursing,Nursing Sciences,70 85 5 60 Nursing Sciences 220
56,64,82,18,220,oncology nursing,Nursing Sciences,56 64 82 18 Nursing Sciences 220
48,52,61,59,220,oncology nursing,Nursing Sciences,48 52 61 59 Nursing Sciences 220
58,20,53,89,220,oncology nursing,Nursing Sciences,58 20 53 89 Nursing Sciences 220
24,56,56,84,220,oncology nursing,Nursing Sciences,24 56 56 84 Nursing Sciences 220
28,50,57,85,220,oncology nursing,Nursing Sciences,28 50 57 85 Nursing Sciences 220
14,93,22,91,220,oncology nursing,Nursing Sciences,14 93 22 91 Nursing Sciences 220
39,53,29,99,220,oncology nursing,Nursing Sciences,39 53 29 99 Nursing Sciences 220
49,39,62,70,220,oncology nursing,Nursing Sciences,49 39 62 70 Nursing Sciences 220
71,35,40,74,220,oncology nursing,Nursing Sciences,71 35 40 74 Nursing Sciences 220
82,11,95,32,220,oncology nursing,Nursing Sciences,82 11 95 32 Nursing Sciences 220
64,69,66,21,220,oncology nursing,Nursing Sciences,64 69 66 21 Nursing Sciences 220
88,76,34,22,220,oncology nursing,Nursing Sciences,88 76 34 22 Nursing Sciences 220
57,88,66,9,220,oncology nursing,Nursing Sciences,57 88 66 9 Nursing Sciences 220
88,50,32,50,220,oncology nursing,Nursing Sciences,88 50 32 50 Nursing Sciences 220
74,88,12,46,220,oncology nursing,Nursing Sciences,74 88 12 46 Nursing Sciences 220
35,76,70,39,220,oncology nursing,Nursing Sciences,35 76 70 39 Nursing Sciences 220
18,62,59,81,220,oncology nursing,Nursing Sciences,18 62 59 81 Nursing Sciences 220
54,61,27,78,220,oncology nursing,Nursing Sciences,54 61 27 78 Nursing Sciences 220
37,83,78,22,220,oncology nursing,Nursing Sciences,37 83 78 22 Nursing Sciences 220
61,0,84,75,220,oncology nursing,Nursing Sciences,61 0 84 75 Nursing Sciences 220
13,46,91,70,220,oncology nursing,Nursing Sciences,13 46 91 70 Nursing Sciences 220
97,24,79,20,220,oncology nursing,Nursing Sciences,97 24 79 20 Nursing Sciences 220
46,37,48,89,220,oncology nursing,Nursing Sciences,46 37 48 89 Nursing Sciences 220
23,53,94,51,221,plant sciences,Agricultural Sciences,23 53 94 51 Agricultural Sciences 221
99,62,49,11,221,plant sciences,Agricultural Sciences,99 62 49 11 Agricultural Sciences 221
9,58,77,77,221,plant sciences,Agricultural Sciences,9 58 77 77 Agricultural Sciences 221
81,54,71,15,221,plant sciences,Agricultural Sciences,81 54 71 15 Agricultural Sciences 221
68,43,80,30,221,plant sciences,Agricultural Sciences,68 43 80 30 Agricultural Sciences 221
7,55,67,92,221,plant sciences,Agricultural Sciences,7 55 67 92 Agricultural Sciences 221
90,77,7,47,221,plant sciences,Agricultural Sciences,90 77 7 47 Agricultural Sciences 221
18,68,45,90,221,plant sciences,Agricultural Sciences,18 68 45 90 Agricultural Sciences 221
34,81,69,37,221,plant sciences,Agricultural Sciences,34 81 69 37 Agricultural Sciences 221
47,62,87,25,221,plant sciences,Agricultural Sciences,47 62 87 25 Agricultural Sciences 221
78,39,75,29,221,plant sciences,Agricultural Sciences,78 39 75 29 Agricultural Sciences 221
82,12,94,33,221,plant sciences,Agricultural Sciences,82 12 94 33 Agricultural Sciences 221
65,87,67,2,221,plant sciences,Agricultural Sciences,65 87 67 2 Agricultural Sciences 221
72,17,84,48,221,plant sciences,Agricultural Sciences,72 17 84 48 Agricultural Sciences 221
69,81,56,15,221,plant sciences,Agricultural Sciences,69 81 56 15 Agricultural Sciences 221
87,97,11,26,221,plant sciences,Agricultural Sciences,87 97 11 26 Agricultural Sciences 221
32,20,77,92,221,plant sciences,Agricultural Sciences,32 20 77 92 Agricultural Sciences 221
39,10,93,79,221,plant sciences,Agricultural Sciences,39 10 93 79 Agricultural Sciences 221
55,66,81,19,221,plant sciences,Agricultural Sciences,55 66 81 19 Agricultural Sciences 221
87,68,58,8,221,plant sciences,Agricultural Sciences,87 68 58 8 Agricultural Sciences 221
49,58,37,77,221,plant sciences,Agricultural Sciences,49 58 37 77 Agricultural Sciences 221
66,43,18,94,221,plant sciences,Agricultural Sciences,66 43 18 94 Agricultural Sciences 221
74,21,41,85,221,plant sciences,Agricultural Sciences,74 21 41 85 Agricultural Sciences 221
27,99,9,86,221,plant sciences,Agricultural Sciences,27 99 9 86 Agricultural Sciences 221
77,61,41,42,221,plant sciences,Agricultural Sciences,77 61 41 42 Agricultural Sciences 221
64,21,90,46,221,plant sciences,Agricultural Sciences,64 21 90 46 Agricultural Sciences 221
100,27,7,87,221,plant sciences,Agricultural Sciences,100 27 7 87 Agricultural Sciences 221
42,40,67,72,221,plant sciences,Agricultural Sciences,42 40 67 72 Agricultural Sciences 221
29,43,69,80,221,plant sciences,Agricultural Sciences,29 43 69 80 Agricultural Sciences 221
18,86,81,36,221,plant sciences,Agricultural Sciences,18 86 81 36 Agricultural Sciences 221
79,15,63,64,221,plant sciences,Agricultural Sciences,79 15 63 64 Agricultural Sciences 221
81,50,73,17,221,plant sciences,Agricultural Sciences,81 50 73 17 Agricultural Sciences 221
42,92,37,50,221,plant sciences,Agricultural Sciences,42 92 37 50 Agricultural Sciences 221
67,33,48,73,221,plant sciences,Agricultural Sciences,67 33 48 73 Agricultural Sciences 221
68,56,48,49,221,plant sciences,Agricultural Sciences,68 56 48 49 Agricultural Sciences 221
12,49,85,75,221,plant sciences,Agricultural Sciences,12 49 85 75 Agricultural Sciences 221
27,29,90,76,222,plant sciences,Agricultural Sciences,27 29 90 76 Agricultural Sciences 222
65,44,76,37,222,plant sciences,Agricultural Sciences,65 44 76 37 Agricultural Sciences 222
38,72,62,50,222,plant sciences,Agricultural Sciences,38 72 62 50 Agricultural Sciences 222
50,70,69,33,222,plant sciences,Agricultural Sciences,50 70 69 33 Agricultural Sciences 222
39,30,76,77,222,plant sciences,Agricultural Sciences,39 30 76 77 Agricultural Sciences 222
9,86,59,68,222,plant sciences,Agricultural Sciences,9 86 59 68 Agricultural Sciences 222
43,64,67,48,222,plant sciences,Agricultural Sciences,43 64 67 48 Agricultural Sciences 222
75,25,24,98,222,plant sciences,Agricultural Sciences,75 25 24 98 Agricultural Sciences 222
49,44,80,49,222,plant sciences,Agricultural Sciences,49 44 80 49 Agricultural Sciences 222
62,75,11,74,222,plant sciences,Agricultural Sciences,62 75 11 74 Agricultural Sciences 222
77,28,28,89,222,plant sciences,Agricultural Sciences,77 28 28 89 Agricultural Sciences 222
71,51,68,32,222,plant sciences,Agricultural Sciences,71 51 68 32 Agricultural Sciences 222
98,21,63,40,222,plant sciences,Agricultural Sciences,98 21 63 40 Agricultural Sciences 222
49,78,32,63,222,plant sciences,Agricultural Sciences,49 78 32 63 Agricultural Sciences 222
98,15,26,83,222,plant sciences,Agricultural Sciences,98 15 26 83 Agricultural Sciences 222
80,25,19,98,222,plant sciences,Agricultural Sciences,80 25 19 98 Agricultural Sciences 222
44,75,84,19,222,plant sciences,Agricultural Sciences,44 75 84 19 Agricultural Sciences 222
4,36,92,90,222,plant sciences,Agricultural Sciences,4 36 92 90 Agricultural Sciences 222
55,72,90,5,222,plant sciences,Agricultural Sciences,55 72 90 5 Agricultural Sciences 222
83,4,40,95,222,plant sciences,Agricultural Sciences,83 4 40 95 Agricultural Sciences 222
98,4,98,22,222,plant sciences,Agricultural Sciences,98 4 98 22 Agricultural Sciences 222
85,43,74,20,222,plant sciences,Agricultural Sciences,85 43 74 20 Agricultural Sciences 222
67,72,29,54,222,plant sciences,Agricultural Sciences,67 72 29 54 Agricultural Sciences 222
45,23,83,71,222,plant sciences,Agricultural Sciences,45 23 83 71 Agricultural Sciences 222
99,19,98,6,222,plant sciences,Agricultural Sciences,99 19 98 6 Agricultural Sciences 222
90,34,57,41,222,plant sciences,Agricultural Sciences,90 34 57 41 Agricultural Sciences 222
20,68,36,98,222,plant sciences,Agricultural Sciences,20 68 36 98 Agricultural Sciences 222
73,50,60,39,222,plant sciences,Agricultural Sciences,73 50 60 39 Agricultural Sciences 222
61,7,77,77,222,plant sciences,Agricultural Sciences,61 7 77 77 Agricultural Sciences 222
82,25,68,47,222,plant sciences,Agricultural Sciences,82 25 68 47 Agricultural Sciences 222
83,14,91,34,222,plant sciences,Agricultural Sciences,83 14 91 34 Agricultural Sciences 222
29,94,39,60,222,plant sciences,Agricultural Sciences,29 94 39 60 Agricultural Sciences 222
69,72,65,16,222,plant sciences,Agricultural Sciences,69 72 65 16 Agricultural Sciences 222
80,65,17,60,222,plant sciences,Agricultural Sciences,80 65 17 60 Agricultural Sciences 222
93,15,62,52,222,plant sciences,Agricultural Sciences,93 15 62 52 Agricultural Sciences 222
68,53,74,27,222,plant sciences,Agricultural Sciences,68 53 74 27 Agricultural Sciences 222
52,63,67,40,222,plant sciences,Agricultural Sciences,52 63 67 40 Agricultural Sciences 222
59,7,78,78,222,plant sciences,Agricultural Sciences,59 7 78 78 Agricultural Sciences 222
87,6,68,62,223,plant sciences,Agricultural Sciences,87 6 68 62 Agricultural Sciences 223
70,84,64,5,223,plant sciences,Agricultural Sciences,70 84 64 5 Agricultural Sciences 223
45,93,61,24,223,plant sciences,Agricultural Sciences,45 93 61 24 Agricultural Sciences 223
69,62,28,64,223,plant sciences,Agricultural Sciences,69 62 28 64 Agricultural Sciences 223
47,80,60,36,223,plant sciences,Agricultural Sciences,47 80 60 36 Agricultural Sciences 223
49,62,46,66,223,plant sciences,Agricultural Sciences,49 62 46 66 Agricultural Sciences 223
18,27,96,82,223,plant sciences,Agricultural Sciences,18 27 96 82 Agricultural Sciences 223
39,79,86,19,223,plant sciences,Agricultural Sciences,39 79 86 19 Agricultural Sciences 223
49,80,48,46,223,plant sciences,Agricultural Sciences,49 80 48 46 Agricultural Sciences 223
28,74,74,47,223,plant sciences,Agricultural Sciences,28 74 74 47 Agricultural Sciences 223
26,93,82,22,223,plant sciences,Agricultural Sciences,26 93 82 22 Agricultural Sciences 223
77,24,63,59,223,plant sciences,Agricultural Sciences,77 24 63 59 Agricultural Sciences 223
81,59,53,30,223,plant sciences,Agricultural Sciences,81 59 53 30 Agricultural Sciences 223
97,12,94,20,223,plant sciences,Agricultural Sciences,97 12 94 20 Agricultural Sciences 223
91,39,79,14,223,plant sciences,Agricultural Sciences,91 39 79 14 Agricultural Sciences 223
51,62,60,50,223,plant sciences,Agricultural Sciences,51 62 60 50 Agricultural Sciences 223
44,34,91,54,223,plant sciences,Agricultural Sciences,44 34 91 54 Agricultural Sciences 223
34,63,81,45,223,plant sciences,Agricultural Sciences,34 63 81 45 Agricultural Sciences 223
2,55,67,99,223,plant sciences,Agricultural Sciences,2 55 67 99 Agricultural Sciences 223
83,23,84,33,223,plant sciences,Agricultural Sciences,83 23 84 33 Agricultural Sciences 223
55,60,53,55,223,plant sciences,Agricultural Sciences,55 60 53 55 Agricultural Sciences 223
67,30,47,79,223,plant sciences,Agricultural Sciences,67 30 47 79 Agricultural Sciences 223
73,42,44,64,223,plant sciences,Agricultural Sciences,73 42 44 64 Agricultural Sciences 223
78,33,90,22,223,plant sciences,Agricultural Sciences,78 33 90 22 Agricultural Sciences 223
83,45,85,10,223,plant sciences,Agricultural Sciences,83 45 85 10 Agricultural Sciences 223
3,98,74,48,223,plant sciences,Agricultural Sciences,3 98 74 48 Agricultural Sciences 223
0,55,93,75,223,plant sciences,Agricultural Sciences,0 55 93 75 Agricultural Sciences 223
29,71,63,60,223,plant sciences,Agricultural Sciences,29 71 63 60 Agricultural Sciences 223
76,60,29,58,223,plant sciences,Agricultural Sciences,76 60 29 58 Agricultural Sciences 223
54,68,31,71,224,plant sciences,Agricultural Sciences,54 68 31 71 Agricultural Sciences 224
87,82,3,52,224,plant sciences,Agricultural Sciences,87 82 3 52 Agricultural Sciences 224
38,99,26,61,224,plant sciences,Agricultural Sciences,38 99 26 61 Agricultural Sciences 224
58,50,92,24,224,plant sciences,Agricultural Sciences,58 50 92 24 Agricultural Sciences 224
54,7,90,73,224,plant sciences,Agricultural Sciences,54 7 90 73 Agricultural Sciences 224
66,92,38,28,224,plant sciences,Agricultural Sciences,66 92 38 28 Agricultural Sciences 224
60,70,57,37,224,plant sciences,Agricultural Sciences,60 70 57 37 Agricultural Sciences 224
79,50,23,72,224,plant sciences,Agricultural Sciences,79 50 23 72 Agricultural Sciences 224
94,27,91,12,224,plant sciences,Agricultural Sciences,94 27 91 12 Agricultural Sciences 224
0,34,90,100,224,plant sciences,Agricultural Sciences,0 34 90 100 Agricultural Sciences 224
24,46,57,97,224,plant sciences,Agricultural Sciences,24 46 57 97 Agricultural Sciences 224
96,0,92,36,224,plant sciences,Agricultural Sciences,96 0 92 36 Agricultural Sciences 224
54,26,65,79,224,plant sciences,Agricultural Sciences,54 26 65 79 Agricultural Sciences 224
94,80,22,28,224,plant sciences,Agricultural Sciences,94 80 22 28 Agricultural Sciences 224
16,87,22,99,224,plant sciences,Agricultural Sciences,16 87 22 99 Agricultural Sciences 224
31,78,28,87,224,plant sciences,Agricultural Sciences,31 78 28 87 Agricultural Sciences 224
50,97,45,32,224,plant sciences,Agricultural Sciences,50 97 45 32 Agricultural Sciences 224
88,54,24,58,224,plant sciences,Agricultural Sciences,88 54 24 58 Agricultural Sciences 224
89,64,26,45,224,plant sciences,Agricultural Sciences,89 64 26 45 Agricultural Sciences 224
36,54,60,74,224,plant sciences,Agricultural Sciences,36 54 60 74 Agricultural Sciences 224
48,81,61,34,224,plant sciences,Agricultural Sciences,48 81 61 34 Agricultural Sciences 224
50,12,76,86,224,plant sciences,Agricultural Sciences,50 12 76 86 Agricultural Sciences 224
53,99,38,34,224,plant sciences,Agricultural Sciences,53 99 38 34 Agricultural Sciences 224
55,75,74,20,224,plant sciences,Agricultural Sciences,55 75 74 20 Agricultural Sciences 224
71,76,59,18,224,plant sciences,Agricultural Sciences,71 76 59 18 Agricultural Sciences 224
57,58,50,59,224,plant sciences,Agricultural Sciences,57 58 50 59 Agricultural Sciences 224
56,58,100,10,224,plant sciences,Agricultural Sciences,56 58 100 10 Agricultural Sciences 224
26,92,79,27,224,plant sciences,Agricultural Sciences,26 92 79 27 Agricultural Sciences 224
38,35,81,70,224,plant sciences,Agricultural Sciences,38 35 81 70 Agricultural Sciences 224
77,70,30,47,224,plant sciences,Agricultural Sciences,77 70 30 47 Agricultural Sciences 224
58,6,68,92,224,plant sciences,Agricultural Sciences,58 6 68 92 Agricultural Sciences 224
50,41,46,87,224,plant sciences,Agricultural Sciences,50 41 46 87 Agricultural Sciences 224
50,71,58,45,224,plant sciences,Agricultural Sciences,50 71 58 45 Agricultural Sciences 224
26,52,84,62,224,plant sciences,Agricultural Sciences,26 52 84 62 Agricultural Sciences 224
59,42,61,62,224,plant sciences,Agricultural Sciences,59 42 61 62 Agricultural Sciences 224
98,29,16,81,224,plant sciences,Agricultural Sciences,98 29 16 81 Agricultural Sciences 224
18,73,47,86,224,plant sciences,Agricultural Sciences,18 73 47 86 Agricultural Sciences 224
85,3,95,41,224,plant sciences,Agricultural Sciences,85 3 95 41 Agricultural Sciences 224
89,2,37,96,224,plant sciences,Agricultural Sciences,89 2 37 96 Agricultural Sciences 224
60,45,49,70,224,plant sciences,Agricultural Sciences,60 45 49 70 Agricultural Sciences 224
35,58,73,58,224,plant sciences,Agricultural Sciences,35 58 73 58 Agricultural Sciences 224
42,84,55,43,224,plant sciences,Agricultural Sciences,42 84 55 43 Agricultural Sciences 224
58,80,26,60,224,plant sciences,Agricultural Sciences,58 80 26 60 Agricultural Sciences 224
36,0,91,98,225,plant sciences,Agricultural Sciences,36 0 91 98 Agricultural Sciences 225
76,50,3,96,225,plant sciences,Agricultural Sciences,76 50 3 96 Agricultural Sciences 225
74,54,76,21,225,plant sciences,Agricultural Sciences,74 54 76 21 Agricultural Sciences 225
19,75,58,73,225,plant sciences,Agricultural Sciences,19 75 58 73 Agricultural Sciences 225
55,94,69,7,225,plant sciences,Agricultural Sciences,55 94 69 7 Agricultural Sciences 225
98,25,40,62,225,plant sciences,Agricultural Sciences,98 25 40 62 Agricultural Sciences 225
76,28,46,75,225,plant sciences,Agricultural Sciences,76 28 46 75 Agricultural Sciences 225
25,80,74,46,225,plant sciences,Agricultural Sciences,25 80 74 46 Agricultural Sciences 225
37,44,91,53,225,plant sciences,Agricultural Sciences,37 44 91 53 Agricultural Sciences 225
43,90,55,37,225,plant sciences,Agricultural Sciences,43 90 55 37 Agricultural Sciences 225
98,7,82,38,225,plant sciences,Agricultural Sciences,98 7 82 38 Agricultural Sciences 225
52,50,84,39,225,plant sciences,Agricultural Sciences,52 50 84 39 Agricultural Sciences 225
31,46,84,64,225,plant sciences,Agricultural Sciences,31 46 84 64 Agricultural Sciences 225
44,42,88,51,225,plant sciences,Agricultural Sciences,44 42 88 51 Agricultural Sciences 225
96,0,84,45,225,plant sciences,Agricultural Sciences,96 0 84 45 Agricultural Sciences 225
22,88,40,75,225,plant sciences,Agricultural Sciences,22 88 40 75 Agricultural Sciences 225
43,82,40,60,225,plant sciences,Agricultural Sciences,43 82 40 60 Agricultural Sciences 225
26,83,83,33,225,plant sciences,Agricultural Sciences,26 83 83 33 Agricultural Sciences 225
84,64,53,24,225,plant sciences,Agricultural Sciences,84 64 53 24 Agricultural Sciences 225
95,35,79,16,225,plant sciences,Agricultural Sciences,95 35 79 16 Agricultural Sciences 225
0,35,90,100,225,plant sciences,Agricultural Sciences,0 35 90 100 Agricultural Sciences 225
70,31,95,29,225,plant sciences,Agricultural Sciences,70 31 95 29 Agricultural Sciences 225
45,27,71,82,225,plant sciences,Agricultural Sciences,45 27 71 82 Agricultural Sciences 225
17,45,71,92,225,plant sciences,Agricultural Sciences,17 45 71 92 Agricultural Sciences 225
50,25,73,77,225,plant sciences,Agricultural Sciences,50 25 73 77 Agricultural Sciences 225
9,56,85,75,225,plant sciences,Agricultural Sciences,9 56 85 75 Agricultural Sciences 225
7,64,80,74,225,plant sciences,Agricultural Sciences,7 64 80 74 Agricultural Sciences 225
61,34,41,89,225,plant sciences,Agricultural Sciences,61 34 41 89 Agricultural Sciences 225
51,86,4,84,225,plant sciences,Agricultural Sciences,51 86 4 84 Agricultural Sciences 225
84,49,76,16,225,plant sciences,Agricultural Sciences,84 49 76 16 Agricultural Sciences 225
60,52,74,39,225,plant sciences,Agricultural Sciences,60 52 74 39 Agricultural Sciences 225
95,39,55,36,225,plant sciences,Agricultural Sciences,95 39 55 36 Agricultural Sciences 225
54,0,92,79,225,plant sciences,Agricultural Sciences,54 0 92 79 Agricultural Sciences 225
69,20,56,80,225,plant sciences,Agricultural Sciences,69 20 56 80 Agricultural Sciences 225
96,10,36,83,225,plant sciences,Agricultural Sciences,96 10 36 83 Agricultural Sciences 225
29,74,70,52,225,plant sciences,Agricultural Sciences,29 74 70 52 Agricultural Sciences 225
51,30,75,69,225,plant sciences,Agricultural Sciences,51 30 75 69 Agricultural Sciences 225
54,98,22,52,226,posthetics & orthotics,Health Sciences,54 98 22 52 Health Sciences 226
70,3,61,92,226,posthetics & orthotics,Health Sciences,70 3 61 92 Health Sciences 226
92,47,31,56,226,posthetics & orthotics,Health Sciences,92 47 31 56 Health Sciences 226
2,52,96,76,226,posthetics & orthotics,Health Sciences,2 52 96 76 Health Sciences 226
62,68,87,9,226,posthetics & orthotics,Health Sciences,62 68 87 9 Health Sciences 226
31,41,88,66,226,posthetics & orthotics,Health Sciences,31 41 88 66 Health Sciences 226
62,8,100,56,226,posthetics & orthotics,Health Sciences,62 8 100 56 Health Sciences 226
71,44,52,59,226,posthetics & orthotics,Health Sciences,71 44 52 59 Health Sciences 226
73,49,79,25,226,posthetics & orthotics,Health Sciences,73 49 79 25 Health Sciences 226
41,17,79,89,226,posthetics & orthotics,Health Sciences,41 17 79 89 Health Sciences 226
92,20,77,37,226,posthetics & orthotics,Health Sciences,92 20 77 37 Health Sciences 226
38,20,70,98,226,posthetics & orthotics,Health Sciences,38 20 70 98 Health Sciences 226
66,34,80,46,226,posthetics & orthotics,Health Sciences,66 34 80 46 Health Sciences 226
86,50,50,40,226,posthetics & orthotics,Health Sciences,86 50 50 40 Health Sciences 226
93,34,96,3,226,posthetics & orthotics,Health Sciences,93 34 96 3 Health Sciences 226
26,98,22,80,226,posthetics & orthotics,Health Sciences,26 98 22 80 Health Sciences 226
67,71,58,30,226,posthetics & orthotics,Health Sciences,67 71 58 30 Health Sciences 226
96,43,39,48,226,posthetics & orthotics,Health Sciences,96 43 39 48 Health Sciences 226
48,69,42,67,226,posthetics & orthotics,Health Sciences,48 69 42 67 Health Sciences 226
15,41,79,91,226,posthetics & orthotics,Health Sciences,15 41 79 91 Health Sciences 226
99,8,19,100,226,posthetics & orthotics,Health Sciences,99 8 19 100 Health Sciences 226
96,45,67,18,226,posthetics & orthotics,Health Sciences,96 45 67 18 Health Sciences 226
75,42,92,17,226,posthetics & orthotics,Health Sciences,75 42 92 17 Health Sciences 226
28,84,35,79,226,posthetics & orthotics,Health Sciences,28 84 35 79 Health Sciences 226
7,63,60,96,226,posthetics & orthotics,Health Sciences,7 63 60 96 Health Sciences 226
52,77,40,57,226,posthetics & orthotics,Health Sciences,52 77 40 57 Health Sciences 226
86,30,15,95,226,posthetics & orthotics,Health Sciences,86 30 15 95 Health Sciences 226
90,12,30,94,226,posthetics & orthotics,Health Sciences,90 12 30 94 Health Sciences 226
55,46,53,72,226,posthetics & orthotics,Health Sciences,55 46 53 72 Health Sciences 226
11,93,66,56,226,posthetics & orthotics,Health Sciences,11 93 66 56 Health Sciences 226
80,49,97,0,226,posthetics & orthotics,Health Sciences,80 49 97 0 Health Sciences 226
50,82,12,82,226,posthetics & orthotics,Health Sciences,50 82 12 82 Health Sciences 226
72,91,22,41,226,posthetics & orthotics,Health Sciences,72 91 22 41 Health Sciences 226
79,82,18,47,226,posthetics & orthotics,Health Sciences,79 82 18 47 Health Sciences 226
81,84,43,19,227,posthetics & orthotics,Health Sciences,81 84 43 19 Health Sciences 227
76,0,73,78,227,posthetics & orthotics,Health Sciences,76 0 73 78 Health Sciences 227
93,19,94,21,227,posthetics & orthotics,Health Sciences,93 19 94 21 Health Sciences 227
73,31,44,79,227,posthetics & orthotics,Health Sciences,73 31 44 79 Health Sciences 227
74,82,52,19,227,posthetics & orthotics,Health Sciences,74 82 52 19 Health Sciences 227
70,71,27,59,227,posthetics & orthotics,Health Sciences,70 71 27 59 Health Sciences 227
60,39,36,92,227,posthetics & orthotics,Health Sciences,60 39 36 92 Health Sciences 227
80,26,81,40,227,posthetics & orthotics,Health Sciences,80 26 81 40 Health Sciences 227
59,44,89,35,227,posthetics & orthotics,Health Sciences,59 44 89 35 Health Sciences 227
70,86,36,35,227,posthetics & orthotics,Health Sciences,70 86 36 35 Health Sciences 227
70,31,81,45,227,posthetics & orthotics,Health Sciences,70 31 81 45 Health Sciences 227
65,85,68,9,227,posthetics & orthotics,Health Sciences,65 85 68 9 Health Sciences 227
66,68,69,24,227,posthetics & orthotics,Health Sciences,66 68 69 24 Health Sciences 227
26,91,23,87,227,posthetics & orthotics,Health Sciences,26 91 23 87 Health Sciences 227
84,63,51,29,227,posthetics & orthotics,Health Sciences,84 63 51 29 Health Sciences 227
82,34,18,93,227,posthetics & orthotics,Health Sciences,82 34 18 93 Health Sciences 227
90,8,33,96,227,posthetics & orthotics,Health Sciences,90 8 33 96 Health Sciences 227
84,7,98,38,227,posthetics & orthotics,Health Sciences,84 7 98 38 Health Sciences 227
39,68,68,52,227,posthetics & orthotics,Health Sciences,39 68 68 52 Health Sciences 227
54,52,72,49,227,posthetics & orthotics,Health Sciences,54 52 72 49 Health Sciences 227
29,91,23,84,227,posthetics & orthotics,Health Sciences,29 91 23 84 Health Sciences 227
52,81,72,22,227,posthetics & orthotics,Health Sciences,52 81 72 22 Health Sciences 227
46,46,96,39,227,posthetics & orthotics,Health Sciences,46 46 96 39 Health Sciences 227
77,88,42,20,227,posthetics & orthotics,Health Sciences,77 88 42 20 Health Sciences 227
23,49,70,85,227,posthetics & orthotics,Health Sciences,23 49 70 85 Health Sciences 227
96,31,81,19,227,posthetics & orthotics,Health Sciences,96 31 81 19 Health Sciences 227
78,51,86,12,227,posthetics & orthotics,Health Sciences,78 51 86 12 Health Sciences 227
53,50,86,38,227,posthetics & orthotics,Health Sciences,53 50 86 38 Health Sciences 227
78,31,64,54,227,posthetics & orthotics,Health Sciences,78 31 64 54 Health Sciences 227
5,87,62,73,227,posthetics & orthotics,Health Sciences,5 87 62 73 Health Sciences 227
22,69,85,51,227,posthetics & orthotics,Health Sciences,22 69 85 51 Health Sciences 227
70,29,38,90,227,posthetics & orthotics,Health Sciences,70 29 38 90 Health Sciences 227
85,22,63,57,227,posthetics & orthotics,Health Sciences,85 22 63 57 Health Sciences 227
79,18,74,56,227,posthetics & orthotics,Health Sciences,79 18 74 56 Health Sciences 227
40,49,60,78,227,posthetics & orthotics,Health Sciences,40 49 60 78 Health Sciences 227
58,91,71,8,228,posthetics & orthotics,Health Sciences,58 91 71 8 Health Sciences 228
65,52,79,32,228,posthetics & orthotics,Health Sciences,65 52 79 32 Health Sciences 228
24,93,28,83,228,posthetics & orthotics,Health Sciences,24 93 28 83 Health Sciences 228
64,63,41,60,228,posthetics & orthotics,Health Sciences,64 63 41 60 Health Sciences 228
8,80,54,86,228,posthetics & orthotics,Health Sciences,8 80 54 86 Health Sciences 228
57,99,0,72,228,posthetics & orthotics,Health Sciences,57 99 0 72 Health Sciences 228
54,91,10,73,228,posthetics & orthotics,Health Sciences,54 91 10 73 Health Sciences 228
61,50,97,20,228,posthetics & orthotics,Health Sciences,61 50 97 20 Health Sciences 228
62,12,88,66,228,posthetics & orthotics,Health Sciences,62 12 88 66 Health Sciences 228
30,31,83,84,228,posthetics & orthotics,Health Sciences,30 31 83 84 Health Sciences 228
51,78,60,39,228,posthetics & orthotics,Health Sciences,51 78 60 39 Health Sciences 228
78,74,47,29,228,posthetics & orthotics,Health Sciences,78 74 47 29 Health Sciences 228
74,68,76,10,228,posthetics & orthotics,Health Sciences,74 68 76 10 Health Sciences 228
11,81,62,74,228,posthetics & orthotics,Health Sciences,11 81 62 74 Health Sciences 228
46,59,63,60,228,posthetics & orthotics,Health Sciences,46 59 63 60 Health Sciences 228
70,28,73,57,228,posthetics & orthotics,Health Sciences,70 28 73 57 Health Sciences 228
61,61,40,66,228,posthetics & orthotics,Health Sciences,61 61 40 66 Health Sciences 228
94,33,79,22,228,posthetics & orthotics,Health Sciences,94 33 79 22 Health Sciences 228
44,100,74,10,228,posthetics & orthotics,Health Sciences,44 100 74 10 Health Sciences 228
72,54,71,31,228,posthetics & orthotics,Health Sciences,72 54 71 31 Health Sciences 228
57,37,86,48,228,posthetics & orthotics,Health Sciences,57 37 86 48 Health Sciences 228
18,26,94,90,228,posthetics & orthotics,Health Sciences,18 26 94 90 Health Sciences 228
91,18,50,69,228,posthetics & orthotics,Health Sciences,91 18 50 69 Health Sciences 228
8,59,66,95,228,posthetics & orthotics,Health Sciences,8 59 66 95 Health Sciences 228
15,95,81,37,228,posthetics & orthotics,Health Sciences,15 95 81 37 Health Sciences 228
56,22,79,71,228,posthetics & orthotics,Health Sciences,56 22 79 71 Health Sciences 228
94,65,55,14,228,posthetics & orthotics,Health Sciences,94 65 55 14 Health Sciences 228
78,50,24,76,228,posthetics & orthotics,Health Sciences,78 50 24 76 Health Sciences 228
100,1,30,97,228,posthetics & orthotics,Health Sciences,100 1 30 97 Health Sciences 228
76,60,17,75,228,posthetics & orthotics,Health Sciences,76 60 17 75 Health Sciences 228
43,5,93,87,228,posthetics & orthotics,Health Sciences,43 5 93 87 Health Sciences 228
58,40,66,64,228,posthetics & orthotics,Health Sciences,58 40 66 64 Health Sciences 228
41,92,80,15,228,posthetics & orthotics,Health Sciences,41 92 80 15 Health Sciences 228
48,71,17,92,228,posthetics & orthotics,Health Sciences,48 71 17 92 Health Sciences 228
25,32,86,85,228,posthetics & orthotics,Health Sciences,25 32 86 85 Health Sciences 228
70,76,17,65,228,posthetics & orthotics,Health Sciences,70 76 17 65 Health Sciences 228
58,95,70,5,228,posthetics & orthotics,Health Sciences,58 95 70 5 Health Sciences 228
51,84,90,3,228,posthetics & orthotics,Health Sciences,51 84 90 3 Health Sciences 228
41,92,30,65,228,posthetics & orthotics,Health Sciences,41 92 30 65 Health Sciences 228
63,31,67,67,228,posthetics & orthotics,Health Sciences,63 31 67 67 Health Sciences 228
77,12,43,96,228,posthetics & orthotics,Health Sciences,77 12 43 96 Health Sciences 228
75,77,71,5,228,posthetics & orthotics,Health Sciences,75 77 71 5 Health Sciences 228
66,32,47,84,229,posthetics & orthotics,Health Sciences,66 32 47 84 Health Sciences 229
89,65,40,35,229,posthetics & orthotics,Health Sciences,89 65 40 35 Health Sciences 229
44,88,88,9,229,posthetics & orthotics,Health Sciences,44 88 88 9 Health Sciences 229
63,88,42,36,229,posthetics & orthotics,Health Sciences,63 88 42 36 Health Sciences 229
54,22,69,84,229,posthetics & orthotics,Health Sciences,54 22 69 84 Health Sciences 229
17,76,61,75,229,posthetics & orthotics,Health Sciences,17 76 61 75 Health Sciences 229
57,78,58,36,229,posthetics & orthotics,Health Sciences,57 78 58 36 Health Sciences 229
30,75,91,33,229,posthetics & orthotics,Health Sciences,30 75 91 33 Health Sciences 229
62,9,86,72,229,posthetics & orthotics,Health Sciences,62 9 86 72 Health Sciences 229
37,22,93,77,229,posthetics & orthotics,Health Sciences,37 22 93 77 Health Sciences 229
81,69,69,10,229,posthetics & orthotics,Health Sciences,81 69 69 10 Health Sciences 229
82,50,41,56,229,posthetics & orthotics,Health Sciences,82 50 41 56 Health Sciences 229
75,86,52,16,229,posthetics & orthotics,Health Sciences,75 86 52 16 Health Sciences 229
56,47,31,95,229,posthetics & orthotics,Health Sciences,56 47 31 95 Health Sciences 229
50,38,48,93,229,posthetics & orthotics,Health Sciences,50 38 48 93 Health Sciences 229
60,58,77,34,229,posthetics & orthotics,Health Sciences,60 58 77 34 Health Sciences 229
97,50,17,65,229,posthetics & orthotics,Health Sciences,97 50 17 65 Health Sciences 229
36,60,60,73,229,posthetics & orthotics,Health Sciences,36 60 60 73 Health Sciences 229
92,1,92,44,229,posthetics & orthotics,Health Sciences,92 1 92 44 Health Sciences 229
49,29,62,89,229,posthetics & orthotics,Health Sciences,49 29 62 89 Health Sciences 229
49,57,82,41,229,posthetics & orthotics,Health Sciences,49 57 82 41 Health Sciences 229
44,94,80,11,229,posthetics & orthotics,Health Sciences,44 94 80 11 Health Sciences 229
67,25,91,46,229,posthetics & orthotics,Health Sciences,67 25 91 46 Health Sciences 229
52,99,73,5,229,posthetics & orthotics,Health Sciences,52 99 73 5 Health Sciences 229
67,53,15,94,229,posthetics & orthotics,Health Sciences,67 53 15 94 Health Sciences 229
69,81,77,2,229,posthetics & orthotics,Health Sciences,69 81 77 2 Health Sciences 229
70,97,53,9,229,posthetics & orthotics,Health Sciences,70 97 53 9 Health Sciences 229
61,83,28,57,229,posthetics & orthotics,Health Sciences,61 83 28 57 Health Sciences 229
90,48,84,7,229,posthetics & orthotics,Health Sciences,90 48 84 7 Health Sciences 229
53,70,56,50,229,posthetics & orthotics,Health Sciences,53 70 56 50 Health Sciences 229
67,69,38,55,229,posthetics & orthotics,Health Sciences,67 69 38 55 Health Sciences 229
94,8,40,87,229,posthetics & orthotics,Health Sciences,94 8 40 87 Health Sciences 229
69,17,61,82,229,posthetics & orthotics,Health Sciences,69 17 61 82 Health Sciences 229
54,15,61,99,229,posthetics & orthotics,Health Sciences,54 15 61 99 Health Sciences 229
58,13,60,98,229,posthetics & orthotics,Health Sciences,58 13 60 98 Health Sciences 229
81,18,52,78,229,posthetics & orthotics,Health Sciences,81 18 52 78 Health Sciences 229
90,63,33,43,229,posthetics & orthotics,Health Sciences,90 63 33 43 Health Sciences 229
33,62,81,54,230,posthetics & orthotics,Health Sciences,33 62 81 54 Health Sciences 230
80,16,87,47,230,posthetics & orthotics,Health Sciences,80 16 87 47 Health Sciences 230
87,46,80,17,230,posthetics & orthotics,Health Sciences,87 46 80 17 Health Sciences 230
52,72,94,12,230,posthetics & orthotics,Health Sciences,52 72 94 12 Health Sciences 230
41,76,24,89,230,posthetics & orthotics,Health Sciences,41 76 24 89 Health Sciences 230
56,65,63,46,230,posthetics & orthotics,Health Sciences,56 65 63 46 Health Sciences 230
79,67,72,12,230,posthetics & orthotics,Health Sciences,79 67 72 12 Health Sciences 230
53,59,59,59,230,posthetics & orthotics,Health Sciences,53 59 59 59 Health Sciences 230
81,37,72,40,230,posthetics & orthotics,Health Sciences,81 37 72 40 Health Sciences 230
74,50,49,57,230,posthetics & orthotics,Health Sciences,74 50 49 57 Health Sciences 230
83,35,14,98,230,posthetics & orthotics,Health Sciences,83 35 14 98 Health Sciences 230
43,71,71,45,230,posthetics & orthotics,Health Sciences,43 71 71 45 Health Sciences 230
100,35,94,1,230,posthetics & orthotics,Health Sciences,100 35 94 1 Health Sciences 230
89,74,45,22,230,posthetics & orthotics,Health Sciences,89 74 45 22 Health Sciences 230
66,76,73,15,230,posthetics & orthotics,Health Sciences,66 76 73 15 Health Sciences 230
49,62,54,65,230,posthetics & orthotics,Health Sciences,49 62 54 65 Health Sciences 230
45,77,77,31,230,posthetics & orthotics,Health Sciences,45 77 77 31 Health Sciences 230
83,98,21,28,230,posthetics & orthotics,Health Sciences,83 98 21 28 Health Sciences 230
78,45,62,45,230,posthetics & orthotics,Health Sciences,78 45 62 45 Health Sciences 230
31,72,64,63,230,posthetics & orthotics,Health Sciences,31 72 64 63 Health Sciences 230
8,94,48,80,230,posthetics & orthotics,Health Sciences,8 94 48 80 Health Sciences 230
69,69,81,11,230,posthetics & orthotics,Health Sciences,69 69 81 11 Health Sciences 230
69,45,16,100,230,posthetics & orthotics,Health Sciences,69 45 16 100 Health Sciences 230
62,67,86,15,230,posthetics & orthotics,Health Sciences,62 67 86 15 Health Sciences 230
57,5,85,83,230,posthetics & orthotics,Health Sciences,57 5 85 83 Health Sciences 230
95,64,27,44,230,posthetics & orthotics,Health Sciences,95 64 27 44 Health Sciences 230
0,83,59,88,230,posthetics & orthotics,Health Sciences,0 83 59 88 Health Sciences 230
47,85,58,40,230,posthetics & orthotics,Health Sciences,47 85 58 40 Health Sciences 230
53,72,57,48,230,posthetics & orthotics,Health Sciences,53 72 57 48 Health Sciences 230
79,52,74,25,230,posthetics & orthotics,Health Sciences,79 52 74 25 Health Sciences 230
38,87,47,58,230,posthetics & orthotics,Health Sciences,38 87 47 58 Health Sciences 230
70,56,9,95,230,posthetics & orthotics,Health Sciences,70 56 9 95 Health Sciences 230
20,86,65,59,230,posthetics & orthotics,Health Sciences,20 86 65 59 Health Sciences 230
42,90,57,41,230,posthetics & orthotics,Health Sciences,42 90 57 41 Health Sciences 230
86,30,65,49,230,posthetics & orthotics,Health Sciences,86 30 65 49 Health Sciences 230
60,100,33,37,230,posthetics & orthotics,Health Sciences,60 100 33 37 Health Sciences 230
56,72,62,40,230,posthetics & orthotics,Health Sciences,56 72 62 40 Health Sciences 230
47,82,39,62,230,posthetics & orthotics,Health Sciences,47 82 39 62 Health Sciences 230
16,37,80,97,230,posthetics & orthotics,Health Sciences,16 37 80 97 Health Sciences 230
53,72,74,31,230,posthetics & orthotics,Health Sciences,53 72 74 31 Health Sciences 230
82,33,48,68,231,molecular biology & genetics,Natural Sciences,82 33 48 68 Natural Sciences 231
50,60,55,66,231,molecular biology & genetics,Natural Sciences,50 60 55 66 Natural Sciences 231
79,50,81,21,231,molecular biology & genetics,Natural Sciences,79 50 81 21 Natural Sciences 231
31,74,84,42,231,molecular biology & genetics,Natural Sciences,31 74 84 42 Natural Sciences 231
27,73,78,53,231,molecular biology & genetics,Natural Sciences,27 73 78 53 Natural Sciences 231
71,11,89,60,231,molecular biology & genetics,Natural Sciences,71 11 89 60 Natural Sciences 231
43,86,14,88,231,molecular biology & genetics,Natural Sciences,43 86 14 88 Natural Sciences 231
48,36,85,62,231,molecular biology & genetics,Natural Sciences,48 36 85 62 Natural Sciences 231
72,63,56,40,231,molecular biology & genetics,Natural Sciences,72 63 56 40 Natural Sciences 231
60,53,59,59,231,molecular biology & genetics,Natural Sciences,60 53 59 59 Natural Sciences 231
40,92,28,71,231,molecular biology & genetics,Natural Sciences,40 92 28 71 Natural Sciences 231
37,54,77,63,231,molecular biology & genetics,Natural Sciences,37 54 77 63 Natural Sciences 231
73,44,74,40,231,molecular biology & genetics,Natural Sciences,73 44 74 40 Natural Sciences 231
90,18,84,39,231,molecular biology & genetics,Natural Sciences,90 18 84 39 Natural Sciences 231
24,16,98,93,231,molecular biology & genetics,Natural Sciences,24 16 98 93 Natural Sciences 231
59,58,78,36,231,molecular biology & genetics,Natural Sciences,59 58 78 36 Natural Sciences 231
12,50,73,96,231,molecular biology & genetics,Natural Sciences,12 50 73 96 Natural Sciences 231
75,60,13,83,231,molecular biology & genetics,Natural Sciences,75 60 13 83 Natural Sciences 231
72,51,86,22,231,molecular biology & genetics,Natural Sciences,72 51 86 22 Natural Sciences 231
76,65,36,54,231,molecular biology & genetics,Natural Sciences,76 65 36 54 Natural Sciences 231
46,12,90,83,231,molecular biology & genetics,Natural Sciences,46 12 90 83 Natural Sciences 231
25,96,66,44,231,molecular biology & genetics,Natural Sciences,25 96 66 44 Natural Sciences 231
47,45,68,71,231,molecular biology & genetics,Natural Sciences,47 45 68 71 Natural Sciences 231
89,37,42,63,231,molecular biology & genetics,Natural Sciences,89 37 42 63 Natural Sciences 231
73,73,82,3,231,molecular biology & genetics,Natural Sciences,73 73 82 3 Natural Sciences 231
73,4,59,95,231,molecular biology & genetics,Natural Sciences,73 4 59 95 Natural Sciences 231
42,38,68,83,231,molecular biology & genetics,Natural Sciences,42 38 68 83 Natural Sciences 231
93,50,29,59,231,molecular biology & genetics,Natural Sciences,93 50 29 59 Natural Sciences 231
86,22,100,23,231,molecular biology & genetics,Natural Sciences,86 22 100 23 Natural Sciences 231
72,52,73,34,231,molecular biology & genetics,Natural Sciences,72 52 73 34 Natural Sciences 231
83,28,26,94,231,molecular biology & genetics,Natural Sciences,83 28 26 94 Natural Sciences 231
52,39,73,67,231,molecular biology & genetics,Natural Sciences,52 39 73 67 Natural Sciences 231
13,90,60,68,231,molecular biology & genetics,Natural Sciences,13 90 60 68 Natural Sciences 231
82,48,86,15,231,molecular biology & genetics,Natural Sciences,82 48 86 15 Natural Sciences 231
62,54,58,57,231,molecular biology & genetics,Natural Sciences,62 54 58 57 Natural Sciences 231
50,82,2,97,231,molecular biology & genetics,Natural Sciences,50 82 2 97 Natural Sciences 231
80,34,19,98,231,molecular biology & genetics,Natural Sciences,80 34 19 98 Natural Sciences 231
23,91,90,28,232,molecular biology & genetics,Natural Sciences,23 91 90 28 Natural Sciences 232
62,7,67,96,232,molecular biology & genetics,Natural Sciences,62 7 67 96 Natural Sciences 232
10,52,75,95,232,molecular biology & genetics,Natural Sciences,10 52 75 95 Natural Sciences 232
65,18,74,75,232,molecular biology & genetics,Natural Sciences,65 18 74 75 Natural Sciences 232
47,93,65,27,232,molecular biology & genetics,Natural Sciences,47 93 65 27 Natural Sciences 232
58,54,60,60,232,molecular biology & genetics,Natural Sciences,58 54 60 60 Natural Sciences 232
47,50,45,90,232,molecular biology & genetics,Natural Sciences,47 50 45 90 Natural Sciences 232
80,0,68,84,232,molecular biology & genetics,Natural Sciences,80 0 68 84 Natural Sciences 232
25,77,56,74,232,molecular biology & genetics,Natural Sciences,25 77 56 74 Natural Sciences 232
41,62,95,34,232,molecular biology & genetics,Natural Sciences,41 62 95 34 Natural Sciences 232
28,26,80,98,232,molecular biology & genetics,Natural Sciences,28 26 80 98 Natural Sciences 232
79,5,90,58,232,molecular biology & genetics,Natural Sciences,79 5 90 58 Natural Sciences 232
50,27,65,90,232,molecular biology & genetics,Natural Sciences,50 27 65 90 Natural Sciences 232
74,27,84,47,232,molecular biology & genetics,Natural Sciences,74 27 84 47 Natural Sciences 232
23,42,76,91,232,molecular biology & genetics,Natural Sciences,23 42 76 91 Natural Sciences 232
97,10,70,55,232,molecular biology & genetics,Natural Sciences,97 10 70 55 Natural Sciences 232
60,78,85,9,232,molecular biology & genetics,Natural Sciences,60 78 85 9 Natural Sciences 232
41,26,93,72,232,molecular biology & genetics,Natural Sciences,41 26 93 72 Natural Sciences 232
74,38,63,57,232,molecular biology & genetics,Natural Sciences,74 38 63 57 Natural Sciences 232
79,47,65,41,232,molecular biology & genetics,Natural Sciences,79 47 65 41 Natural Sciences 232
77,25,31,99,232,molecular biology & genetics,Natural Sciences,77 25 31 99 Natural Sciences 232
34,82,70,46,232,molecular biology & genetics,Natural Sciences,34 82 70 46 Natural Sciences 232
62,52,47,71,232,molecular biology & genetics,Natural Sciences,62 52 47 71 Natural Sciences 232
64,70,53,45,232,molecular biology & genetics,Natural Sciences,64 70 53 45 Natural Sciences 232
95,26,45,66,232,molecular biology & genetics,Natural Sciences,95 26 45 66 Natural Sciences 232
21,55,68,88,232,molecular biology & genetics,Natural Sciences,21 55 68 88 Natural Sciences 232
66,8,65,93,232,molecular biology & genetics,Natural Sciences,66 8 65 93 Natural Sciences 232
94,67,51,20,232,molecular biology & genetics,Natural Sciences,94 67 51 20 Natural Sciences 232
48,71,49,64,232,molecular biology & genetics,Natural Sciences,48 71 49 64 Natural Sciences 232
59,26,80,67,232,molecular biology & genetics,Natural Sciences,59 26 80 67 Natural Sciences 232
40,85,71,36,232,molecular biology & genetics,Natural Sciences,40 85 71 36 Natural Sciences 232
71,35,81,45,232,molecular biology & genetics,Natural Sciences,71 35 81 45 Natural Sciences 232
40,59,95,38,232,molecular biology & genetics,Natural Sciences,40 59 95 38 Natural Sciences 232
58,96,57,21,232,molecular biology & genetics,Natural Sciences,58 96 57 21 Natural Sciences 232
81,52,13,86,232,molecular biology & genetics,Natural Sciences,81 52 13 86 Natural Sciences 232
41,48,95,48,232,molecular biology & genetics,Natural Sciences,41 48 95 48 Natural Sciences 232
35,8,96,93,232,molecular biology & genetics,Natural Sciences,35 8 96 93 Natural Sciences 232
87,50,80,15,232,molecular biology & genetics,Natural Sciences,87 50 80 15 Natural Sciences 232
37,40,68,87,232,molecular biology & genetics,Natural Sciences,37 40 68 87 Natural Sciences 232
27,75,78,52,232,molecular biology & genetics,Natural Sciences,27 75 78 52 Natural Sciences 232
22,53,81,77,233,molecular biology & genetics,Natural Sciences,22 53 81 77 Natural Sciences 233
50,19,100,64,233,molecular biology & genetics,Natural Sciences,50 19 100 64 Natural Sciences 233
86,16,36,95,233,molecular biology & genetics,Natural Sciences,86 16 36 95 Natural Sciences 233
71,96,41,25,233,molecular biology & genetics,Natural Sciences,71 96 41 25 Natural Sciences 233
96,30,98,9,233,molecular biology & genetics,Natural Sciences,96 30 98 9 Natural Sciences 233
75,73,47,38,233,molecular biology & genetics,Natural Sciences,75 73 47 38 Natural Sciences 233
81,5,78,69,233,molecular biology & genetics,Natural Sciences,81 5 78 69 Natural Sciences 233
15,49,71,98,233,molecular biology & genetics,Natural Sciences,15 49 71 98 Natural Sciences 233
37,86,87,23,233,molecular biology & genetics,Natural Sciences,37 86 87 23 Natural Sciences 233
27,54,64,88,233,molecular biology & genetics,Natural Sciences,27 54 64 88 Natural Sciences 233
75,35,79,44,233,molecular biology & genetics,Natural Sciences,75 35 79 44 Natural Sciences 233
6,81,58,88,233,molecular biology & genetics,Natural Sciences,6 81 58 88 Natural Sciences 233
72,10,74,77,233,molecular biology & genetics,Natural Sciences,72 10 74 77 Natural Sciences 233
70,90,56,17,233,molecular biology & genetics,Natural Sciences,70 90 56 17 Natural Sciences 233
89,22,90,32,233,molecular biology & genetics,Natural Sciences,89 22 90 32 Natural Sciences 233
23,98,51,61,233,molecular biology & genetics,Natural Sciences,23 98 51 61 Natural Sciences 233
76,100,24,33,233,molecular biology & genetics,Natural Sciences,76 100 24 33 Natural Sciences 233
24,50,94,65,233,molecular biology & genetics,Natural Sciences,24 50 94 65 Natural Sciences 233
31,74,44,84,233,molecular biology & genetics,Natural Sciences,31 74 44 84 Natural Sciences 233
40,74,27,92,233,molecular biology & genetics,Natural Sciences,40 74 27 92 Natural Sciences 233
66,67,79,21,233,molecular biology & genetics,Natural Sciences,66 67 79 21 Natural Sciences 233
46,90,30,67,233,molecular biology & genetics,Natural Sciences,46 90 30 67 Natural Sciences 233
21,98,23,91,233,molecular biology & genetics,Natural Sciences,21 98 23 91 Natural Sciences 233
91,24,84,34,233,molecular biology & genetics,Natural Sciences,91 24 84 34 Natural Sciences 233
88,57,82,6,233,molecular biology & genetics,Natural Sciences,88 57 82 6 Natural Sciences 233
33,52,95,53,233,molecular biology & genetics,Natural Sciences,33 52 95 53 Natural Sciences 233
51,66,28,88,233,molecular biology & genetics,Natural Sciences,51 66 28 88 Natural Sciences 233
92,70,42,29,233,molecular biology & genetics,Natural Sciences,92 70 42 29 Natural Sciences 233
73,74,65,21,233,molecular biology & genetics,Natural Sciences,73 74 65 21 Natural Sciences 233
50,70,50,63,233,molecular biology & genetics,Natural Sciences,50 70 50 63 Natural Sciences 233
38,93,8,95,234,molecular biology & genetics,Natural Sciences,38 93 8 95 Natural Sciences 234
29,83,28,94,234,molecular biology & genetics,Natural Sciences,29 83 28 94 Natural Sciences 234
18,52,80,84,234,molecular biology & genetics,Natural Sciences,18 52 80 84 Natural Sciences 234
81,51,92,10,234,molecular biology & genetics,Natural Sciences,81 51 92 10 Natural Sciences 234
83,77,49,25,234,molecular biology & genetics,Natural Sciences,83 77 49 25 Natural Sciences 234
49,39,81,65,234,molecular biology & genetics,Natural Sciences,49 39 81 65 Natural Sciences 234
83,69,75,7,234,molecular biology & genetics,Natural Sciences,83 69 75 7 Natural Sciences 234
24,41,83,86,234,molecular biology & genetics,Natural Sciences,24 41 83 86 Natural Sciences 234
79,55,83,17,234,molecular biology & genetics,Natural Sciences,79 55 83 17 Natural Sciences 234
53,24,70,87,234,molecular biology & genetics,Natural Sciences,53 24 70 87 Natural Sciences 234
26,76,83,49,234,molecular biology & genetics,Natural Sciences,26 76 83 49 Natural Sciences 234
38,67,69,60,234,molecular biology & genetics,Natural Sciences,38 67 69 60 Natural Sciences 234
65,66,96,7,234,molecular biology & genetics,Natural Sciences,65 66 96 7 Natural Sciences 234
53,33,53,95,234,molecular biology & genetics,Natural Sciences,53 33 53 95 Natural Sciences 234
40,67,45,82,234,molecular biology & genetics,Natural Sciences,40 67 45 82 Natural Sciences 234
72,66,59,37,234,molecular biology & genetics,Natural Sciences,72 66 59 37 Natural Sciences 234
73,28,35,98,234,molecular biology & genetics,Natural Sciences,73 28 35 98 Natural Sciences 234
5,94,40,95,234,molecular biology & genetics,Natural Sciences,5 94 40 95 Natural Sciences 234
12,97,97,28,234,molecular biology & genetics,Natural Sciences,12 97 97 28 Natural Sciences 234
21,67,57,89,234,molecular biology & genetics,Natural Sciences,21 67 57 89 Natural Sciences 234
81,84,61,8,234,molecular biology & genetics,Natural Sciences,81 84 61 8 Natural Sciences 234
22,71,67,74,234,molecular biology & genetics,Natural Sciences,22 71 67 74 Natural Sciences 234
27,77,38,92,234,molecular biology & genetics,Natural Sciences,27 77 38 92 Natural Sciences 234
56,49,58,71,234,molecular biology & genetics,Natural Sciences,56 49 58 71 Natural Sciences 234
73,95,45,21,234,molecular biology & genetics,Natural Sciences,73 95 45 21 Natural Sciences 234
41,52,92,49,234,molecular biology & genetics,Natural Sciences,41 52 92 49 Natural Sciences 234
84,35,73,43,235,molecular biology & genetics,Natural Sciences,84 35 73 43 Natural Sciences 235
50,22,86,77,235,molecular biology & genetics,Natural Sciences,50 22 86 77 Natural Sciences 235
42,67,45,81,235,molecular biology & genetics,Natural Sciences,42 67 45 81 Natural Sciences 235
66,67,81,21,235,molecular biology & genetics,Natural Sciences,66 67 81 21 Natural Sciences 235
86,45,76,28,235,molecular biology & genetics,Natural Sciences,86 45 76 28 Natural Sciences 235
39,81,19,96,235,molecular biology & genetics,Natural Sciences,39 81 19 96 Natural Sciences 235
100,0,92,43,235,molecular biology & genetics,Natural Sciences,100 0 92 43 Natural Sciences 235
55,19,85,76,235,molecular biology & genetics,Natural Sciences,55 19 85 76 Natural Sciences 235
73,66,34,62,235,molecular biology & genetics,Natural Sciences,73 66 34 62 Natural Sciences 235
47,54,66,68,235,molecular biology & genetics,Natural Sciences,47 54 66 68 Natural Sciences 235
28,32,85,90,235,molecular biology & genetics,Natural Sciences,28 32 85 90 Natural Sciences 235
64,97,68,6,235,molecular biology & genetics,Natural Sciences,64 97 68 6 Natural Sciences 235
30,59,61,85,235,molecular biology & genetics,Natural Sciences,30 59 61 85 Natural Sciences 235
50,80,73,32,235,molecular biology & genetics,Natural Sciences,50 80 73 32 Natural Sciences 235
27,97,50,61,235,molecular biology & genetics,Natural Sciences,27 97 50 61 Natural Sciences 235
87,50,93,5,235,molecular biology & genetics,Natural Sciences,87 50 93 5 Natural Sciences 235
62,78,28,67,235,molecular biology & genetics,Natural Sciences,62 78 28 67 Natural Sciences 235
75,41,46,73,235,molecular biology & genetics,Natural Sciences,75 41 46 73 Natural Sciences 235
93,55,78,9,235,molecular biology & genetics,Natural Sciences,93 55 78 9 Natural Sciences 235
23,98,52,62,235,molecular biology & genetics,Natural Sciences,23 98 52 62 Natural Sciences 235
43,38,76,78,235,molecular biology & genetics,Natural Sciences,43 38 76 78 Natural Sciences 235
59,71,90,15,235,molecular biology & genetics,Natural Sciences,59 71 90 15 Natural Sciences 235
82,50,82,21,235,molecular biology & genetics,Natural Sciences,82 50 82 21 Natural Sciences 235
50,71,50,64,235,molecular biology & genetics,Natural Sciences,50 71 50 64 Natural Sciences 235
49,50,82,54,235,molecular biology & genetics,Natural Sciences,49 50 82 54 Natural Sciences 235
74,51,71,39,235,molecular biology & genetics,Natural Sciences,74 51 71 39 Natural Sciences 235
63,65,34,73,235,molecular biology & genetics,Natural Sciences,63 65 34 73 Natural Sciences 235
14,77,96,48,235,molecular biology & genetics,Natural Sciences,14 77 96 48 Natural Sciences 235
52,68,60,56,236,clinical medicine,Medicine,52 68 60 56 Medicine 236
50,82,12,92,236,clinical medicine,Medicine,50 82 12 92 Medicine 236
45,71,44,76,236,clinical medicine,Medicine,45 71 44 76 Medicine 236
14,83,61,78,236,clinical medicine,Medicine,14 83 61 78 Medicine 236
52,85,76,23,236,clinical medicine,Medicine,52 85 76 23 Medicine 236
91,46,49,50,236,clinical medicine,Medicine,91 46 49 50 Medicine 236
95,94,14,33,236,clinical medicine,Medicine,95 94 14 33 Medicine 236
58,45,64,69,236,clinical medicine,Medicine,58 45 64 69 Medicine 236
0,83,70,83,236,clinical medicine,Medicine,0 83 70 83 Medicine 236
80,33,54,69,236,clinical medicine,Medicine,80 33 54 69 Medicine 236
63,86,30,57,236,clinical medicine,Medicine,63 86 30 57 Medicine 236
54,79,49,54,236,clinical medicine,Medicine,54 79 49 54 Medicine 236
47,65,26,98,236,clinical medicine,Medicine,47 65 26 98 Medicine 236
91,50,75,20,236,clinical medicine,Medicine,91 50 75 20 Medicine 236
61,98,36,41,236,clinical medicine,Medicine,61 98 36 41 Medicine 236
95,7,58,76,236,clinical medicine,Medicine,95 7 58 76 Medicine 236
30,69,91,46,236,clinical medicine,Medicine,30 69 91 46 Medicine 236
59,91,70,16,236,clinical medicine,Medicine,59 91 70 16 Medicine 236
61,77,67,31,236,clinical medicine,Medicine,61 77 67 31 Medicine 236
81,14,61,80,236,clinical medicine,Medicine,81 14 61 80 Medicine 236
24,63,98,51,236,clinical medicine,Medicine,24 63 98 51 Medicine 236
35,99,58,44,236,clinical medicine,Medicine,35 99 58 44 Medicine 236
96,66,36,38,236,clinical medicine,Medicine,96 66 36 38 Medicine 236
81,63,79,13,236,clinical medicine,Medicine,81 63 79 13 Medicine 236
38,87,28,83,236,clinical medicine,Medicine,38 87 28 83 Medicine 236
8,88,86,54,236,clinical medicine,Medicine,8 88 86 54 Medicine 236
39,68,58,71,236,clinical medicine,Medicine,39 68 58 71 Medicine 236
77,45,34,80,236,clinical medicine,Medicine,77 45 34 80 Medicine 236
62,86,55,33,236,clinical medicine,Medicine,62 86 55 33 Medicine 236
34,70,92,40,236,clinical medicine,Medicine,34 70 92 40 Medicine 236
82,42,93,19,236,clinical medicine,Medicine,82 42 93 19 Medicine 236
94,26,60,56,236,clinical medicine,Medicine,94 26 60 56 Medicine 236
54,53,56,73,236,clinical medicine,Medicine,54 53 56 73 Medicine 236
94,1,82,59,236,clinical medicine,Medicine,94 1 82 59 Medicine 236
82,21,65,69,237,clinical medicine,Medicine,82 21 65 69 Medicine 237
60,86,30,61,237,clinical medicine,Medicine,60 86 30 61 Medicine 237
21,87,83,46,237,clinical medicine,Medicine,21 87 83 46 Medicine 237
70,62,82,23,237,clinical medicine,Medicine,70 62 82 23 Medicine 237
19,55,78,85,237,clinical medicine,Medicine,19 55 78 85 Medicine 237
87,94,14,42,237,clinical medicine,Medicine,87 94 14 42 Medicine 237
8,32,98,99,237,clinical medicine,Medicine,8 32 98 99 Medicine 237
81,41,94,21,237,clinical medicine,Medicine,81 41 94 21 Medicine 237
85,46,82,24,237,clinical medicine,Medicine,85 46 82 24 Medicine 237
84,20,72,61,237,clinical medicine,Medicine,84 20 72 61 Medicine 237
51,94,61,31,237,clinical medicine,Medicine,51 94 61 31 Medicine 237
3,84,56,94,237,clinical medicine,Medicine,3 84 56 94 Medicine 237
70,62,66,39,237,clinical medicine,Medicine,70 62 66 39 Medicine 237
54,85,8,90,237,clinical medicine,Medicine,54 85 8 90 Medicine 237
93,39,11,94,237,clinical medicine,Medicine,93 39 11 94 Medicine 237
65,87,72,13,237,clinical medicine,Medicine,65 87 72 13 Medicine 237
51,71,56,59,237,clinical medicine,Medicine,51 71 56 59 Medicine 237
93,91,49,4,237,clinical medicine,Medicine,93 91 49 4 Medicine 237
76,55,73,33,237,clinical medicine,Medicine,76 55 73 33 Medicine 237
53,88,89,7,237,clinical medicine,Medicine,53 88 89 7 Medicine 237
44,77,56,60,237,clinical medicine,Medicine,44 77 56 60 Medicine 237
85,85,59,8,237,clinical medicine,Medicine,85 85 59 8 Medicine 237
82,49,40,66,237,clinical medicine,Medicine,82 49 40 66 Medicine 237
34,50,81,72,237,clinical medicine,Medicine,34 50 81 72 Medicine 237
49,55,79,54,237,clinical medicine,Medicine,49 55 79 54 Medicine 237
66,15,95,61,237,clinical medicine,Medicine,66 15 95 61 Medicine 237
82,59,54,42,237,clinical medicine,Medicine,82 59 54 42 Medicine 237
94,41,74,28,237,clinical medicine,Medicine,94 41 74 28 Medicine 237
95,37,97,8,237,clinical medicine,Medicine,95 37 97 8 Medicine 237
82,77,67,11,237,clinical medicine,Medicine,82 77 67 11 Medicine 237
17,86,46,88,237,clinical medicine,Medicine,17 86 46 88 Medicine 237
61,70,56,51,238,clinical medicine,Medicine,61 70 56 51 Medicine 238
86,8,81,63,238,clinical medicine,Medicine,86 8 81 63 Medicine 238
40,60,58,80,238,clinical medicine,Medicine,40 60 58 80 Medicine 238
84,77,75,2,238,clinical medicine,Medicine,84 77 75 2 Medicine 238
41,46,82,69,238,clinical medicine,Medicine,41 46 82 69 Medicine 238
14,62,71,91,238,clinical medicine,Medicine,14 62 71 91 Medicine 238
0,74,65,99,238,clinical medicine,Medicine,0 74 65 99 Medicine 238
62,15,88,73,238,clinical medicine,Medicine,62 15 88 73 Medicine 238
52,24,81,81,238,clinical medicine,Medicine,52 24 81 81 Medicine 238
43,20,77,98,238,clinical medicine,Medicine,43 20 77 98 Medicine 238
87,49,64,38,238,clinical medicine,Medicine,87 49 64 38 Medicine 238
75,13,78,72,238,clinical medicine,Medicine,75 13 78 72 Medicine 238
53,71,98,16,238,clinical medicine,Medicine,53 71 98 16 Medicine 238
67,80,69,22,238,clinical medicine,Medicine,67 80 69 22 Medicine 238
65,60,76,37,238,clinical medicine,Medicine,65 60 76 37 Medicine 238
100,0,84,54,238,clinical medicine,Medicine,100 0 84 54 Medicine 238
53,78,83,24,238,clinical medicine,Medicine,53 78 83 24 Medicine 238
51,21,80,86,238,clinical medicine,Medicine,51 21 80 86 Medicine 238
79,80,79,0,238,clinical medicine,Medicine,79 80 79 0 Medicine 238
34,36,98,70,238,clinical medicine,Medicine,34 36 98 70 Medicine 238
74,33,54,77,238,clinical medicine,Medicine,74 33 54 77 Medicine 238
50,30,75,83,238,clinical medicine,Medicine,50 30 75 83 Medicine 238
66,62,97,13,238,clinical medicine,Medicine,66 62 97 13 Medicine 238
29,81,67,61,238,clinical medicine,Medicine,29 81 67 61 Medicine 238
31,75,61,71,238,clinical medicine,Medicine,31 75 61 71 Medicine 238
54,82,39,63,238,clinical medicine,Medicine,54 82 39 63 Medicine 238
52,67,33,86,238,clinical medicine,Medicine,52 67 33 86 Medicine 238
57,80,45,56,238,clinical medicine,Medicine,57 80 45 56 Medicine 238
79,46,32,82,239,clinical medicine,Medicine,79 46 32 82 Medicine 239
73,33,56,77,239,clinical medicine,Medicine,73 33 56 77 Medicine 239
46,85,66,42,239,clinical medicine,Medicine,46 85 66 42 Medicine 239
38,49,57,95,239,clinical medicine,Medicine,38 49 57 95 Medicine 239
2,58,99,80,239,clinical medicine,Medicine,2 58 99 80 Medicine 239
29,50,94,66,239,clinical medicine,Medicine,29 50 94 66 Medicine 239
47,84,25,83,239,clinical medicine,Medicine,47 84 25 83 Medicine 239
78,50,82,29,239,clinical medicine,Medicine,78 50 82 29 Medicine 239
62,47,64,66,239,clinical medicine,Medicine,62 47 64 66 Medicine 239
75,54,11,99,239,clinical medicine,Medicine,75 54 11 99 Medicine 239
68,30,99,42,239,clinical medicine,Medicine,68 30 99 42 Medicine 239
79,78,61,21,239,clinical medicine,Medicine,79 78 61 21 Medicine 239
33,76,46,84,239,clinical medicine,Medicine,33 76 46 84 Medicine 239
59,73,68,39,239,clinical medicine,Medicine,59 73 68 39 Medicine 239
43,97,20,79,239,clinical medicine,Medicine,43 97 20 79 Medicine 239
36,56,81,66,239,clinical medicine,Medicine,36 56 81 66 Medicine 239
60,35,51,93,239,clinical medicine,Medicine,60 35 51 93 Medicine 239
42,13,97,87,239,clinical medicine,Medicine,42 13 97 87 Medicine 239
97,1,41,100,239,clinical medicine,Medicine,97 1 41 100 Medicine 239
78,73,53,35,239,clinical medicine,Medicine,78 73 53 35 Medicine 239
87,49,78,25,239,clinical medicine,Medicine,87 49 78 25 Medicine 239
63,88,48,40,239,clinical medicine,Medicine,63 88 48 40 Medicine 239
96,10,90,43,239,clinical medicine,Medicine,96 10 90 43 Medicine 239
43,65,57,74,239,clinical medicine,Medicine,43 65 57 74 Medicine 239
52,87,82,18,239,clinical medicine,Medicine,52 87 82 18 Medicine 239
44,10,100,85,239,clinical medicine,Medicine,44 10 100 85 Medicine 239
72,25,98,44,239,clinical medicine,Medicine,72 25 98 44 Medicine 239
62,62,71,44,239,clinical medicine,Medicine,62 62 71 44 Medicine 239
69,27,95,48,239,clinical medicine,Medicine,69 27 95 48 Medicine 239
25,78,61,75,239,clinical medicine,Medicine,25 78 61 75 Medicine 239
55,90,79,15,239,clinical medicine,Medicine,55 90 79 15 Medicine 239
95,33,93,18,239,clinical medicine,Medicine,95 33 93 18 Medicine 239
84,72,76,7,239,clinical medicine,Medicine,84 72 76 7 Medicine 239
52,53,55,79,239,clinical medicine,Medicine,52 53 55 79 Medicine 239
51,41,69,78,239,clinical medicine,Medicine,51 41 69 78 Medicine 239
79,68,51,41,239,clinical medicine,Medicine,79 68 51 41 Medicine 239
43,37,87,72,239,clinical medicine,Medicine,43 37 87 72 Medicine 239
66,44,63,67,240,clinical medicine,Medicine,66 44 63 67 Medicine 240
83,22,75,60,240,clinical medicine,Medicine,83 22 75 60 Medicine 240
57,68,87,28,240,clinical medicine,Medicine,57 68 87 28 Medicine 240
77,60,91,12,240,clinical medicine,Medicine,77 60 91 12 Medicine 240
95,50,38,57,240,clinical medicine,Medicine,95 50 38 57 Medicine 240
81,78,65,16,240,clinical medicine,Medicine,81 78 65 16 Medicine 240
51,93,84,12,240,clinical medicine,Medicine,51 93 84 12 Medicine 240
63,54,49,74,240,clinical medicine,Medicine,63 54 49 74 Medicine 240
31,79,58,72,240,clinical medicine,Medicine,31 79 58 72 Medicine 240
36,82,86,36,240,clinical medicine,Medicine,36 82 86 36 Medicine 240
49,67,74,50,240,clinical medicine,Medicine,49 67 74 50 Medicine 240
24,79,77,60,240,clinical medicine,Medicine,24 79 77 60 Medicine 240
24,82,75,59,240,clinical medicine,Medicine,24 82 75 59 Medicine 240
21,67,69,83,240,clinical medicine,Medicine,21 67 69 83 Medicine 240
42,82,77,39,240,clinical medicine,Medicine,42 82 77 39 Medicine 240
43,52,55,90,240,clinical medicine,Medicine,43 52 55 90 Medicine 240
70,53,87,30,240,clinical medicine,Medicine,70 53 87 30 Medicine 240
44,95,87,14,240,clinical medicine,Medicine,44 95 87 14 Medicine 240
26,50,68,96,240,clinical medicine,Medicine,26 50 68 96 Medicine 240
82,30,59,69,240,clinical medicine,Medicine,82 30 59 69 Medicine 240
75,34,62,69,240,clinical medicine,Medicine,75 34 62 69 Medicine 240
56,64,47,73,240,clinical medicine,Medicine,56 64 47 73 Medicine 240
69,85,79,7,240,clinical medicine,Medicine,69 85 79 7 Medicine 240
35,89,83,33,240,clinical medicine,Medicine,35 89 83 33 Medicine 240
71,89,25,55,240,clinical medicine,Medicine,71 89 25 55 Medicine 240
50,91,31,68,240,clinical medicine,Medicine,50 91 31 68 Medicine 240
98,32,100,10,240,clinical medicine,Medicine,98 32 100 10 Medicine 240
17,74,64,85,240,clinical medicine,Medicine,17 74 64 85 Medicine 240
33,46,85,77,241,animal sciences,Agricultural Sciences,33 46 85 77 Agricultural Sciences 241
64,30,81,66,241,animal sciences,Agricultural Sciences,64 30 81 66 Agricultural Sciences 241
58,62,53,68,241,animal sciences,Agricultural Sciences,58 62 53 68 Agricultural Sciences 241
83,14,96,48,241,animal sciences,Agricultural Sciences,83 14 96 48 Agricultural Sciences 241
89,61,84,7,241,animal sciences,Agricultural Sciences,89 61 84 7 Agricultural Sciences 241
47,47,55,92,241,animal sciences,Agricultural Sciences,47 47 55 92 Agricultural Sciences 241
29,91,74,47,241,animal sciences,Agricultural Sciences,29 91 74 47 Agricultural Sciences 241
91,58,63,29,241,animal sciences,Agricultural Sciences,91 58 63 29 Agricultural Sciences 241
48,87,63,43,241,animal sciences,Agricultural Sciences,48 87 63 43 Agricultural Sciences 241
21,79,61,80,241,animal sciences,Agricultural Sciences,21 79 61 80 Agricultural Sciences 241
96,45,98,2,241,animal sciences,Agricultural Sciences,96 45 98 2 Agricultural Sciences 241
64,88,86,3,241,animal sciences,Agricultural Sciences,64 88 86 3 Agricultural Sciences 241
17,50,89,85,241,animal sciences,Agricultural Sciences,17 50 89 85 Agricultural Sciences 241
68,90,66,17,241,animal sciences,Agricultural Sciences,68 90 66 17 Agricultural Sciences 241
54,68,47,72,241,animal sciences,Agricultural Sciences,54 68 47 72 Agricultural Sciences 241
64,48,78,51,241,animal sciences,Agricultural Sciences,64 48 78 51 Agricultural Sciences 241
60,90,49,42,241,animal sciences,Agricultural Sciences,60 90 49 42 Agricultural Sciences 241
47,81,42,71,241,animal sciences,Agricultural Sciences,47 81 42 71 Agricultural Sciences 241
31,63,68,79,241,animal sciences,Agricultural Sciences,31 63 68 79 Agricultural Sciences 241
53,92,14,82,241,animal sciences,Agricultural Sciences,53 92 14 82 Agricultural Sciences 241
85,50,89,17,241,animal sciences,Agricultural Sciences,85 50 89 17 Agricultural Sciences 241
66,86,63,26,241,animal sciences,Agricultural Sciences,66 86 63 26 Agricultural Sciences 241
46,53,75,67,241,animal sciences,Agricultural Sciences,46 53 75 67 Agricultural Sciences 241
83,54,64,40,241,animal sciences,Agricultural Sciences,83 54 64 40 Agricultural Sciences 241
48,73,54,66,241,animal sciences,Agricultural Sciences,48 73 54 66 Agricultural Sciences 241
30,58,66,87,241,animal sciences,Agricultural Sciences,30 58 66 87 Agricultural Sciences 241
56,6,82,97,241,animal sciences,Agricultural Sciences,56 6 82 97 Agricultural Sciences 241
76,45,67,53,241,animal sciences,Agricultural Sciences,76 45 67 53 Agricultural Sciences 241
33,54,70,84,241,animal sciences,Agricultural Sciences,33 54 70 84 Agricultural Sciences 241
74,49,83,35,241,animal sciences,Agricultural Sciences,74 49 83 35 Agricultural Sciences 241
59,91,81,10,241,animal sciences,Agricultural Sciences,59 91 81 10 Agricultural Sciences 241
96,20,50,75,241,animal sciences,Agricultural Sciences,96 20 50 75 Agricultural Sciences 241
83,27,63,68,241,animal sciences,Agricultural Sciences,83 27 63 68 Agricultural Sciences 241
63,34,70,74,241,animal sciences,Agricultural Sciences,63 34 70 74 Agricultural Sciences 241
44,81,27,90,242,animal sciences,Agricultural Sciences,44 81 27 90 Agricultural Sciences 242
62,77,94,9,242,animal sciences,Agricultural Sciences,62 77 94 9 Agricultural Sciences 242
99,7,91,45,242,animal sciences,Agricultural Sciences,99 7 91 45 Agricultural Sciences 242
80,63,60,39,242,animal sciences,Agricultural Sciences,80 63 60 39 Agricultural Sciences 242
99,7,89,47,242,animal sciences,Agricultural Sciences,99 7 89 47 Agricultural Sciences 242
47,36,67,92,242,animal sciences,Agricultural Sciences,47 36 67 92 Agricultural Sciences 242
70,13,72,87,242,animal sciences,Agricultural Sciences,70 13 72 87 Agricultural Sciences 242
97,57,1,87,242,animal sciences,Agricultural Sciences,97 57 1 87 Agricultural Sciences 242
5,65,96,76,242,animal sciences,Agricultural Sciences,5 65 96 76 Agricultural Sciences 242
74,77,78,13,242,animal sciences,Agricultural Sciences,74 77 78 13 Agricultural Sciences 242
55,62,65,60,242,animal sciences,Agricultural Sciences,55 62 65 60 Agricultural Sciences 242
54,55,50,83,242,animal sciences,Agricultural Sciences,54 55 50 83 Agricultural Sciences 242
56,99,65,22,242,animal sciences,Agricultural Sciences,56 99 65 22 Agricultural Sciences 242
28,29,90,95,242,animal sciences,Agricultural Sciences,28 29 90 95 Agricultural Sciences 242
54,40,70,78,242,animal sciences,Agricultural Sciences,54 40 70 78 Agricultural Sciences 242
66,35,58,83,242,animal sciences,Agricultural Sciences,66 35 58 83 Agricultural Sciences 242
79,72,73,18,242,animal sciences,Agricultural Sciences,79 72 73 18 Agricultural Sciences 242
85,62,33,62,242,animal sciences,Agricultural Sciences,85 62 33 62 Agricultural Sciences 242
32,99,95,16,242,animal sciences,Agricultural Sciences,32 99 95 16 Agricultural Sciences 242
78,40,67,57,242,animal sciences,Agricultural Sciences,78 40 67 57 Agricultural Sciences 242
50,82,82,28,242,animal sciences,Agricultural Sciences,50 82 82 28 Agricultural Sciences 242
67,52,44,79,242,animal sciences,Agricultural Sciences,67 52 44 79 Agricultural Sciences 242
46,72,98,26,242,animal sciences,Agricultural Sciences,46 72 98 26 Agricultural Sciences 242
78,27,65,72,242,animal sciences,Agricultural Sciences,78 27 65 72 Agricultural Sciences 242
59,94,86,3,242,animal sciences,Agricultural Sciences,59 94 86 3 Agricultural Sciences 242
50,97,7,88,242,animal sciences,Agricultural Sciences,50 97 7 88 Agricultural Sciences 242
85,48,96,13,242,animal sciences,Agricultural Sciences,85 48 96 13 Agricultural Sciences 242
42,70,48,82,242,animal sciences,Agricultural Sciences,42 70 48 82 Agricultural Sciences 242
51,31,68,92,242,animal sciences,Agricultural Sciences,51 31 68 92 Agricultural Sciences 242
54,84,74,30,242,animal sciences,Agricultural Sciences,54 84 74 30 Agricultural Sciences 242
73,45,66,58,242,animal sciences,Agricultural Sciences,73 45 66 58 Agricultural Sciences 242
98,39,59,46,242,animal sciences,Agricultural Sciences,98 39 59 46 Agricultural Sciences 242
79,65,81,17,242,animal sciences,Agricultural Sciences,79 65 81 17 Agricultural Sciences 242
63,74,11,94,242,animal sciences,Agricultural Sciences,63 74 11 94 Agricultural Sciences 242
80,91,46,25,242,animal sciences,Agricultural Sciences,80 91 46 25 Agricultural Sciences 242
40,94,78,30,242,animal sciences,Agricultural Sciences,40 94 78 30 Agricultural Sciences 242
12,67,72,91,242,animal sciences,Agricultural Sciences,12 67 72 91 Agricultural Sciences 242
25,39,88,91,243,animal sciences,Agricultural Sciences,25 39 88 91 Agricultural Sciences 243
47,26,74,96,243,animal sciences,Agricultural Sciences,47 26 74 96 Agricultural Sciences 243
98,17,94,34,243,animal sciences,Agricultural Sciences,98 17 94 34 Agricultural Sciences 243
70,86,73,14,243,animal sciences,Agricultural Sciences,70 86 73 14 Agricultural Sciences 243
33,88,72,50,243,animal sciences,Agricultural Sciences,33 88 72 50 Agricultural Sciences 243
79,95,60,9,243,animal sciences,Agricultural Sciences,79 95 60 9 Agricultural Sciences 243
47,78,34,84,243,animal sciences,Agricultural Sciences,47 78 34 84 Agricultural Sciences 243
54,96,86,7,243,animal sciences,Agricultural Sciences,54 96 86 7 Agricultural Sciences 243
90,58,85,10,243,animal sciences,Agricultural Sciences,90 58 85 10 Agricultural Sciences 243
24,100,22,97,243,animal sciences,Agricultural Sciences,24 100 22 97 Agricultural Sciences 243
59,29,92,63,243,animal sciences,Agricultural Sciences,59 29 92 63 Agricultural Sciences 243
81,67,23,72,243,animal sciences,Agricultural Sciences,81 67 23 72 Agricultural Sciences 243
50,83,37,73,243,animal sciences,Agricultural Sciences,50 83 37 73 Agricultural Sciences 243
63,65,63,52,243,animal sciences,Agricultural Sciences,63 65 63 52 Agricultural Sciences 243
92,29,75,47,243,animal sciences,Agricultural Sciences,92 29 75 47 Agricultural Sciences 243
86,5,95,57,243,animal sciences,Agricultural Sciences,86 5 95 57 Agricultural Sciences 243
81,64,3,95,243,animal sciences,Agricultural Sciences,81 64 3 95 Agricultural Sciences 243
84,50,38,71,243,animal sciences,Agricultural Sciences,84 50 38 71 Agricultural Sciences 243
89,12,69,73,243,animal sciences,Agricultural Sciences,89 12 69 73 Agricultural Sciences 243
76,32,53,82,243,animal sciences,Agricultural Sciences,76 32 53 82 Agricultural Sciences 243
61,90,66,26,243,animal sciences,Agricultural Sciences,61 90 66 26 Agricultural Sciences 243
81,38,28,96,243,animal sciences,Agricultural Sciences,81 38 28 96 Agricultural Sciences 243
90,91,50,12,243,animal sciences,Agricultural Sciences,90 91 50 12 Agricultural Sciences 243
79,82,77,5,243,animal sciences,Agricultural Sciences,79 82 77 5 Agricultural Sciences 243
41,53,98,51,243,animal sciences,Agricultural Sciences,41 53 98 51 Agricultural Sciences 243
37,70,71,65,243,animal sciences,Agricultural Sciences,37 70 71 65 Agricultural Sciences 243
70,94,75,4,243,animal sciences,Agricultural Sciences,70 94 75 4 Agricultural Sciences 243
95,50,94,4,243,animal sciences,Agricultural Sciences,95 50 94 4 Agricultural Sciences 243
67,39,78,59,243,animal sciences,Agricultural Sciences,67 39 78 59 Agricultural Sciences 243
60,54,94,35,243,animal sciences,Agricultural Sciences,60 54 94 35 Agricultural Sciences 243
59,39,46,99,243,animal sciences,Agricultural Sciences,59 39 46 99 Agricultural Sciences 243
64,96,65,19,244,animal sciences,Agricultural Sciences,64 96 65 19 Agricultural Sciences 244
76,47,74,47,244,animal sciences,Agricultural Sciences,76 47 74 47 Agricultural Sciences 244
47,62,91,44,244,animal sciences,Agricultural Sciences,47 62 91 44 Agricultural Sciences 244
79,12,60,93,244,animal sciences,Agricultural Sciences,79 12 60 93 Agricultural Sciences 244
90,68,75,11,244,animal sciences,Agricultural Sciences,90 68 75 11 Agricultural Sciences 244
19,91,64,70,244,animal sciences,Agricultural Sciences,19 91 64 70 Agricultural Sciences 244
33,77,97,37,244,animal sciences,Agricultural Sciences,33 77 97 37 Agricultural Sciences 244
91,7,60,86,244,animal sciences,Agricultural Sciences,91 7 60 86 Agricultural Sciences 244
30,53,80,81,244,animal sciences,Agricultural Sciences,30 53 80 81 Agricultural Sciences 244
95,27,44,78,244,animal sciences,Agricultural Sciences,95 27 44 78 Agricultural Sciences 244
67,81,72,24,244,animal sciences,Agricultural Sciences,67 81 72 24 Agricultural Sciences 244
57,64,81,42,244,animal sciences,Agricultural Sciences,57 64 81 42 Agricultural Sciences 244
5,85,94,60,244,animal sciences,Agricultural Sciences,5 85 94 60 Agricultural Sciences 244
86,82,7,69,244,animal sciences,Agricultural Sciences,86 82 7 69 Agricultural Sciences 244
50,58,82,54,244,animal sciences,Agricultural Sciences,50 58 82 54 Agricultural Sciences 244
95,0,88,61,244,animal sciences,Agricultural Sciences,95 0 88 61 Agricultural Sciences 244
79,70,37,58,244,animal sciences,Agricultural Sciences,79 70 37 58 Agricultural Sciences 244
60,90,44,50,244,animal sciences,Agricultural Sciences,60 90 44 50 Agricultural Sciences 244
34,94,71,45,244,animal sciences,Agricultural Sciences,34 94 71 45 Agricultural Sciences 244
40,93,56,55,244,animal sciences,Agricultural Sciences,40 93 56 55 Agricultural Sciences 244
85,11,59,89,244,animal sciences,Agricultural Sciences,85 11 59 89 Agricultural Sciences 244
63,71,38,72,244,animal sciences,Agricultural Sciences,63 71 38 72 Agricultural Sciences 244
58,97,53,36,244,animal sciences,Agricultural Sciences,58 97 53 36 Agricultural Sciences 244
89,72,24,59,244,animal sciences,Agricultural Sciences,89 72 24 59 Agricultural Sciences 244
93,98,1,52,244,animal sciences,Agricultural Sciences,93 98 1 52 Agricultural Sciences 244
65,50,43,87,245,animal sciences,Agricultural Sciences,65 50 43 87 Agricultural Sciences 245
95,23,96,31,245,animal sciences,Agricultural Sciences,95 23 96 31 Agricultural Sciences 245
69,71,94,11,245,animal sciences,Agricultural Sciences,69 71 94 11 Agricultural Sciences 245
60,86,26,73,245,animal sciences,Agricultural Sciences,60 86 26 73 Agricultural Sciences 245
98,3,62,82,245,animal sciences,Agricultural Sciences,98 3 62 82 Agricultural Sciences 245
74,74,39,58,245,animal sciences,Agricultural Sciences,74 74 39 58 Agricultural Sciences 245
59,32,85,69,245,animal sciences,Agricultural Sciences,59 32 85 69 Agricultural Sciences 245
65,45,48,87,245,animal sciences,Agricultural Sciences,65 45 48 87 Agricultural Sciences 245
74,96,3,72,245,animal sciences,Agricultural Sciences,74 96 3 72 Agricultural Sciences 245
55,55,73,62,245,animal sciences,Agricultural Sciences,55 55 73 62 Agricultural Sciences 245
69,42,39,95,245,animal sciences,Agricultural Sciences,69 42 39 95 Agricultural Sciences 245
91,69,44,41,245,animal sciences,Agricultural Sciences,91 69 44 41 Agricultural Sciences 245
91,44,98,12,245,animal sciences,Agricultural Sciences,91 44 98 12 Agricultural Sciences 245
55,40,79,71,245,animal sciences,Agricultural Sciences,55 40 79 71 Agricultural Sciences 245
69,83,60,33,245,animal sciences,Agricultural Sciences,69 83 60 33 Agricultural Sciences 245
97,50,80,18,245,animal sciences,Agricultural Sciences,97 50 80 18 Agricultural Sciences 245
67,46,88,44,245,animal sciences,Agricultural Sciences,67 46 88 44 Agricultural Sciences 245
50,66,53,76,245,animal sciences,Agricultural Sciences,50 66 53 76 Agricultural Sciences 245
94,24,96,31,245,animal sciences,Agricultural Sciences,94 24 96 31 Agricultural Sciences 245
6,84,69,86,245,animal sciences,Agricultural Sciences,6 84 69 86 Agricultural Sciences 245
15,90,48,92,245,animal sciences,Agricultural Sciences,15 90 48 92 Agricultural Sciences 245
68,46,56,75,245,animal sciences,Agricultural Sciences,68 46 56 75 Agricultural Sciences 245
68,55,50,72,245,animal sciences,Agricultural Sciences,68 55 50 72 Agricultural Sciences 245
24,78,91,52,245,animal sciences,Agricultural Sciences,24 78 91 52 Agricultural Sciences 245
89,66,85,5,245,animal sciences,Agricultural Sciences,89 66 85 5 Agricultural Sciences 245
53,32,83,77,245,animal sciences,Agricultural Sciences,53 32 83 77 Agricultural Sciences 245
81,29,55,80,245,animal sciences,Agricultural Sciences,81 29 55 80 Agricultural Sciences 245
33,45,83,84,245,animal sciences,Agricultural Sciences,33 45 83 84 Agricultural Sciences 245
84,79,28,55,246,microbiology,Natural Sciences,84 79 28 55 Natural Sciences 246
86,34,84,42,246,microbiology,Natural Sciences,86 34 84 42 Natural Sciences 246
47,95,37,67,246,microbiology,Natural Sciences,47 95 37 67 Natural Sciences 246
76,45,75,50,246,microbiology,Natural Sciences,76 45 75 50 Natural Sciences 246
78,30,62,76,246,microbiology,Natural Sciences,78 30 62 76 Natural Sciences 246
54,50,78,64,246,microbiology,Natural Sciences,54 50 78 64 Natural Sciences 246
45,97,11,93,246,microbiology,Natural Sciences,45 97 11 93 Natural Sciences 246
23,75,53,95,246,microbiology,Natural Sciences,23 75 53 95 Natural Sciences 246
41,56,74,75,246,microbiology,Natural Sciences,41 56 74 75 Natural Sciences 246
50,55,89,52,246,microbiology,Natural Sciences,50 55 89 52 Natural Sciences 246
50,73,50,73,246,microbiology,Natural Sciences,50 73 50 73 Natural Sciences 246
37,97,24,88,246,microbiology,Natural Sciences,37 97 24 88 Natural Sciences 246
60,49,87,50,246,microbiology,Natural Sciences,60 49 87 50 Natural Sciences 246
68,74,50,54,246,microbiology,Natural Sciences,68 74 50 54 Natural Sciences 246
92,50,26,78,246,microbiology,Natural Sciences,92 50 26 78 Natural Sciences 246
83,84,56,23,246,microbiology,Natural Sciences,83 84 56 23 Natural Sciences 246
61,38,58,89,246,microbiology,Natural Sciences,61 38 58 89 Natural Sciences 246
11,89,85,61,246,microbiology,Natural Sciences,11 89 85 61 Natural Sciences 246
94,47,17,88,246,microbiology,Natural Sciences,94 47 17 88 Natural Sciences 246
78,59,92,17,246,microbiology,Natural Sciences,78 59 92 17 Natural Sciences 246
83,19,88,56,246,microbiology,Natural Sciences,83 19 88 56 Natural Sciences 246
85,99,20,42,246,microbiology,Natural Sciences,85 99 20 42 Natural Sciences 246
77,49,75,45,246,microbiology,Natural Sciences,77 49 75 45 Natural Sciences 246
63,50,89,44,246,microbiology,Natural Sciences,63 50 89 44 Natural Sciences 246
22,53,91,80,246,microbiology,Natural Sciences,22 53 91 80 Natural Sciences 246
30,75,56,85,246,microbiology,Natural Sciences,30 75 56 85 Natural Sciences 246
49,18,96,83,246,microbiology,Natural Sciences,49 18 96 83 Natural Sciences 246
91,38,19,98,246,microbiology,Natural Sciences,91 38 19 98 Natural Sciences 246
61,94,78,13,246,microbiology,Natural Sciences,61 94 78 13 Natural Sciences 246
73,73,77,23,246,microbiology,Natural Sciences,73 73 77 23 Natural Sciences 246
92,68,37,49,246,microbiology,Natural Sciences,92 68 37 49 Natural Sciences 246
97,58,6,86,247,microbiology,Natural Sciences,97 58 6 86 Natural Sciences 247
96,45,100,6,247,microbiology,Natural Sciences,96 45 100 6 Natural Sciences 247
94,53,89,11,247,microbiology,Natural Sciences,94 53 89 11 Natural Sciences 247
67,85,64,31,247,microbiology,Natural Sciences,67 85 64 31 Natural Sciences 247
89,55,84,19,247,microbiology,Natural Sciences,89 55 84 19 Natural Sciences 247
88,41,41,77,247,microbiology,Natural Sciences,88 41 41 77 Natural Sciences 247
33,53,71,90,247,microbiology,Natural Sciences,33 53 71 90 Natural Sciences 247
88,23,67,69,247,microbiology,Natural Sciences,88 23 67 69 Natural Sciences 247
7,60,82,98,247,microbiology,Natural Sciences,7 60 82 98 Natural Sciences 247
83,11,75,78,247,microbiology,Natural Sciences,83 11 75 78 Natural Sciences 247
72,99,62,14,247,microbiology,Natural Sciences,72 99 62 14 Natural Sciences 247
66,88,89,4,247,microbiology,Natural Sciences,66 88 89 4 Natural Sciences 247
12,96,75,64,247,microbiology,Natural Sciences,12 96 75 64 Natural Sciences 247
33,67,54,93,247,microbiology,Natural Sciences,33 67 54 93 Natural Sciences 247
76,59,15,97,247,microbiology,Natural Sciences,76 59 15 97 Natural Sciences 247
72,51,46,78,247,microbiology,Natural Sciences,72 51 46 78 Natural Sciences 247
56,97,39,55,247,microbiology,Natural Sciences,56 97 39 55 Natural Sciences 247
86,78,32,51,247,microbiology,Natural Sciences,86 78 32 51 Natural Sciences 247
77,13,75,82,247,microbiology,Natural Sciences,77 13 75 82 Natural Sciences 247
89,27,86,45,247,microbiology,Natural Sciences,89 27 86 45 Natural Sciences 247
89,21,72,65,247,microbiology,Natural Sciences,89 21 72 65 Natural Sciences 247
30,99,69,49,247,microbiology,Natural Sciences,30 99 69 49 Natural Sciences 247
42,47,84,74,247,microbiology,Natural Sciences,42 47 84 74 Natural Sciences 247
71,23,73,80,247,microbiology,Natural Sciences,71 23 73 80 Natural Sciences 247
89,30,75,53,247,microbiology,Natural Sciences,89 30 75 53 Natural Sciences 247
4,50,95,98,247,microbiology,Natural Sciences,4 50 95 98 Natural Sciences 247
97,25,76,49,247,microbiology,Natural Sciences,97 25 76 49 Natural Sciences 247
68,43,39,97,247,microbiology,Natural Sciences,68 43 39 97 Natural Sciences 247
99,1,47,100,247,microbiology,Natural Sciences,99 1 47 100 Natural Sciences 247
56,61,71,59,247,microbiology,Natural Sciences,56 61 71 59 Natural Sciences 247
91,22,76,58,247,microbiology,Natural Sciences,91 22 76 58 Natural Sciences 247
72,79,83,13,247,microbiology,Natural Sciences,72 79 83 13 Natural Sciences 247
33,67,76,71,247,microbiology,Natural Sciences,33 67 76 71 Natural Sciences 247
68,89,74,16,247,microbiology,Natural Sciences,68 89 74 16 Natural Sciences 247
50,76,46,75,247,microbiology,Natural Sciences,50 76 46 75 Natural Sciences 247
75,50,28,94,247,microbiology,Natural Sciences,75 50 28 94 Natural Sciences 247
26,91,93,37,247,microbiology,Natural Sciences,26 91 93 37 Natural Sciences 247
94,62,91,1,248,microbiology,Natural Sciences,94 62 91 1 Natural Sciences 248
90,15,58,85,248,microbiology,Natural Sciences,90 15 58 85 Natural Sciences 248
35,85,64,64,248,microbiology,Natural Sciences,35 85 64 64 Natural Sciences 248
34,96,45,73,248,microbiology,Natural Sciences,34 96 45 73 Natural Sciences 248
76,27,59,86,248,microbiology,Natural Sciences,76 27 59 86 Natural Sciences 248
77,66,30,75,248,microbiology,Natural Sciences,77 66 30 75 Natural Sciences 248
13,82,91,62,248,microbiology,Natural Sciences,13 82 91 62 Natural Sciences 248
88,61,9,90,248,microbiology,Natural Sciences,88 61 9 90 Natural Sciences 248
68,62,91,27,248,microbiology,Natural Sciences,68 62 91 27 Natural Sciences 248
86,61,58,43,248,microbiology,Natural Sciences,86 61 58 43 Natural Sciences 248
56,94,87,11,248,microbiology,Natural Sciences,56 94 87 11 Natural Sciences 248
66,33,68,81,248,microbiology,Natural Sciences,66 33 68 81 Natural Sciences 248
84,87,25,52,248,microbiology,Natural Sciences,84 87 25 52 Natural Sciences 248
56,7,86,99,248,microbiology,Natural Sciences,56 7 86 99 Natural Sciences 248
94,5,64,85,248,microbiology,Natural Sciences,94 5 64 85 Natural Sciences 248
96,10,83,59,248,microbiology,Natural Sciences,96 10 83 59 Natural Sciences 248
46,64,72,66,248,microbiology,Natural Sciences,46 64 72 66 Natural Sciences 248
97,97,32,22,248,microbiology,Natural Sciences,97 97 32 22 Natural Sciences 248
55,82,46,65,248,microbiology,Natural Sciences,55 82 46 65 Natural Sciences 248
32,28,97,91,248,microbiology,Natural Sciences,32 28 97 91 Natural Sciences 248
14,52,83,99,248,microbiology,Natural Sciences,14 52 83 99 Natural Sciences 248
18,53,77,100,248,microbiology,Natural Sciences,18 53 77 100 Natural Sciences 248
67,88,86,7,248,microbiology,Natural Sciences,67 88 86 7 Natural Sciences 248
65,75,91,17,248,microbiology,Natural Sciences,65 75 91 17 Natural Sciences 248
78,38,71,61,248,microbiology,Natural Sciences,78 38 71 61 Natural Sciences 248
42,89,89,28,248,microbiology,Natural Sciences,42 89 89 28 Natural Sciences 248
55,41,62,90,248,microbiology,Natural Sciences,55 41 62 90 Natural Sciences 248
68,77,30,73,248,microbiology,Natural Sciences,68 77 30 73 Natural Sciences 248
41,92,88,27,248,microbiology,Natural Sciences,41 92 88 27 Natural Sciences 248
60,40,90,58,248,microbiology,Natural Sciences,60 40 90 58 Natural Sciences 248
90,18,87,53,248,microbiology,Natural Sciences,90 18 87 53 Natural Sciences 248
23,95,36,94,248,microbiology,Natural Sciences,23 95 36 94 Natural Sciences 248
76,70,95,8,249,microbiology,Natural Sciences,76 70 95 8 Natural Sciences 249
67,54,48,80,249,microbiology,Natural Sciences,67 54 48 80 Natural Sciences 249
36,83,85,45,249,microbiology,Natural Sciences,36 83 85 45 Natural Sciences 249
57,97,80,15,249,microbiology,Natural Sciences,57 97 80 15 Natural Sciences 249
28,81,71,69,249,microbiology,Natural Sciences,28 81 71 69 Natural Sciences 249
75,18,58,98,249,microbiology,Natural Sciences,75 18 58 98 Natural Sciences 249
43,94,68,44,249,microbiology,Natural Sciences,43 94 68 44 Natural Sciences 249
80,68,55,46,249,microbiology,Natural Sciences,80 68 55 46 Natural Sciences 249
91,84,29,45,249,microbiology,Natural Sciences,91 84 29 45 Natural Sciences 249
76,80,60,33,249,microbiology,Natural Sciences,76 80 60 33 Natural Sciences 249
74,90,72,13,249,microbiology,Natural Sciences,74 90 72 13 Natural Sciences 249
96,22,76,55,249,microbiology,Natural Sciences,96 22 76 55 Natural Sciences 249
47,16,90,96,249,microbiology,Natural Sciences,47 16 90 96 Natural Sciences 249
54,44,79,72,249,microbiology,Natural Sciences,54 44 79 72 Natural Sciences 249
33,68,95,53,249,microbiology,Natural Sciences,33 68 95 53 Natural Sciences 249
74,98,73,4,249,microbiology,Natural Sciences,74 98 73 4 Natural Sciences 249
94,53,98,4,249,microbiology,Natural Sciences,94 53 98 4 Natural Sciences 249
78,75,81,15,249,microbiology,Natural Sciences,78 75 81 15 Natural Sciences 249
65,87,67,30,249,microbiology,Natural Sciences,65 87 67 30 Natural Sciences 249
100,50,49,50,249,microbiology,Natural Sciences,100 50 49 50 Natural Sciences 249
56,78,78,37,249,microbiology,Natural Sciences,56 78 78 37 Natural Sciences 249
63,68,64,54,249,microbiology,Natural Sciences,63 68 64 54 Natural Sciences 249
97,91,26,35,249,microbiology,Natural Sciences,97 91 26 35 Natural Sciences 249
60,33,62,94,249,microbiology,Natural Sciences,60 33 62 94 Natural Sciences 249
50,82,39,78,249,microbiology,Natural Sciences,50 82 39 78 Natural Sciences 249
69,64,20,96,249,microbiology,Natural Sciences,69 64 20 96 Natural Sciences 249
49,2,99,99,249,microbiology,Natural Sciences,49 2 99 99 Natural Sciences 249
71,87,88,3,249,microbiology,Natural Sciences,71 87 88 3 Natural Sciences 249
51,22,99,77,249,microbiology,Natural Sciences,51 22 99 77 Natural Sciences 249
92,76,69,12,249,microbiology,Natural Sciences,92 76 69 12 Natural Sciences 249
79,31,83,56,249,microbiology,Natural Sciences,79 31 83 56 Natural Sciences 249
79,51,70,49,249,microbiology,Natural Sciences,79 51 70 49 Natural Sciences 249
83,29,82,55,249,microbiology,Natural Sciences,83 29 82 55 Natural Sciences 249
73,37,83,56,249,microbiology,Natural Sciences,73 37 83 56 Natural Sciences 249
91,39,95,25,250,microbiology,Natural Sciences,91 39 95 25 Natural Sciences 250
85,67,72,26,250,microbiology,Natural Sciences,85 67 72 26 Natural Sciences 250
52,98,67,33,250,microbiology,Natural Sciences,52 98 67 33 Natural Sciences 250
80,88,72,10,250,microbiology,Natural Sciences,80 88 72 10 Natural Sciences 250
72,10,73,95,250,microbiology,Natural Sciences,72 10 73 95 Natural Sciences 250
66,30,78,76,250,microbiology,Natural Sciences,66 30 78 76 Natural Sciences 250
49,37,87,77,250,microbiology,Natural Sciences,49 37 87 77 Natural Sciences 250
84,25,98,43,250,microbiology,Natural Sciences,84 25 98 43 Natural Sciences 250
77,61,94,18,250,microbiology,Natural Sciences,77 61 94 18 Natural Sciences 250
93,83,33,41,250,microbiology,Natural Sciences,93 83 33 41 Natural Sciences 250
57,4,100,89,250,microbiology,Natural Sciences,57 4 100 89 Natural Sciences 250
21,67,66,96,250,microbiology,Natural Sciences,21 67 66 96 Natural Sciences 250
93,50,98,9,250,microbiology,Natural Sciences,93 50 98 9 Natural Sciences 250
61,82,19,88,250,microbiology,Natural Sciences,61 82 19 88 Natural Sciences 250
72,73,47,58,250,microbiology,Natural Sciences,72 73 47 58 Natural Sciences 250
70,98,52,30,250,microbiology,Natural Sciences,70 98 52 30 Natural Sciences 250
75,47,95,33,250,microbiology,Natural Sciences,75 47 95 33 Natural Sciences 250
56,84,55,55,250,microbiology,Natural Sciences,56 84 55 55 Natural Sciences 250
61,68,51,70,250,microbiology,Natural Sciences,61 68 51 70 Natural Sciences 250
50,33,81,86,250,microbiology,Natural Sciences,50 33 81 86 Natural Sciences 250
49,98,74,29,250,microbiology,Natural Sciences,49 98 74 29 Natural Sciences 250
71,12,68,99,250,microbiology,Natural Sciences,71 12 68 99 Natural Sciences 250
71,93,73,13,250,microbiology,Natural Sciences,71 93 73 13 Natural Sciences 250
69,93,76,12,250,microbiology,Natural Sciences,69 93 76 12 Natural Sciences 250
100,41,9,100,250,microbiology,Natural Sciences,100 41 9 100 Natural Sciences 250
87,83,53,27,250,microbiology,Natural Sciences,87 83 53 27 Natural Sciences 250
50,97,18,85,250,microbiology,Natural Sciences,50 97 18 85 Natural Sciences 250
60,85,71,35,251,midwifery,Nursing Sciences,60 85 71 35 Nursing Sciences 251
96,41,87,27,251,midwifery,Nursing Sciences,96 41 87 27 Nursing Sciences 251
66,59,73,53,251,midwifery,Nursing Sciences,66 59 73 53 Nursing Sciences 251
64,98,78,11,251,midwifery,Nursing Sciences,64 98 78 11 Nursing Sciences 251
91,3,64,93,251,midwifery,Nursing Sciences,91 3 64 93 Nursing Sciences 251
32,50,80,89,251,midwifery,Nursing Sciences,32 50 80 89 Nursing Sciences 251
94,48,89,20,251,midwifery,Nursing Sciences,94 48 89 20 Nursing Sciences 251
54,46,58,93,251,midwifery,Nursing Sciences,54 46 58 93 Nursing Sciences 251
53,22,78,98,251,midwifery,Nursing Sciences,53 22 78 98 Nursing Sciences 251
76,61,74,40,251,midwifery,Nursing Sciences,76 61 74 40 Nursing Sciences 251
84,41,82,44,251,midwifery,Nursing Sciences,84 41 82 44 Nursing Sciences 251
91,34,76,50,251,midwifery,Nursing Sciences,91 34 76 50 Nursing Sciences 251
83,80,66,22,251,midwifery,Nursing Sciences,83 80 66 22 Nursing Sciences 251
56,58,44,93,251,midwifery,Nursing Sciences,56 58 44 93 Nursing Sciences 251
90,77,3,81,251,midwifery,Nursing Sciences,90 77 3 81 Nursing Sciences 251
66,92,93,0,251,midwifery,Nursing Sciences,66 92 93 0 Nursing Sciences 251
70,55,51,75,251,midwifery,Nursing Sciences,70 55 51 75 Nursing Sciences 251
73,62,51,65,251,midwifery,Nursing Sciences,73 62 51 65 Nursing Sciences 251
55,55,70,71,251,midwifery,Nursing Sciences,55 55 70 71 Nursing Sciences 251
28,87,65,71,251,midwifery,Nursing Sciences,28 87 65 71 Nursing Sciences 251
83,62,68,38,251,midwifery,Nursing Sciences,83 62 68 38 Nursing Sciences 251
56,92,97,6,251,midwifery,Nursing Sciences,56 92 97 6 Nursing Sciences 251
16,95,75,65,251,midwifery,Nursing Sciences,16 95 75 65 Nursing Sciences 251
91,46,33,81,251,midwifery,Nursing Sciences,91 46 33 81 Nursing Sciences 251
72,53,51,75,251,midwifery,Nursing Sciences,72 53 51 75 Nursing Sciences 251
53,72,72,54,251,midwifery,Nursing Sciences,53 72 72 54 Nursing Sciences 251
17,50,94,90,251,midwifery,Nursing Sciences,17 50 94 90 Nursing Sciences 251
53,67,75,56,251,midwifery,Nursing Sciences,53 67 75 56 Nursing Sciences 251
34,89,81,48,252,midwifery,Nursing Sciences,34 89 81 48 Nursing Sciences 252
71,64,22,95,252,midwifery,Nursing Sciences,71 64 22 95 Nursing Sciences 252
89,37,73,53,252,midwifery,Nursing Sciences,89 37 73 53 Nursing Sciences 252
45,81,89,37,252,midwifery,Nursing Sciences,45 81 89 37 Nursing Sciences 252
53,39,87,73,252,midwifery,Nursing Sciences,53 39 87 73 Nursing Sciences 252
21,89,87,55,252,midwifery,Nursing Sciences,21 89 87 55 Nursing Sciences 252
68,60,72,52,252,midwifery,Nursing Sciences,68 60 72 52 Nursing Sciences 252
79,28,78,67,252,midwifery,Nursing Sciences,79 28 78 67 Nursing Sciences 252
34,51,76,91,252,midwifery,Nursing Sciences,34 51 76 91 Nursing Sciences 252
63,96,91,2,252,midwifery,Nursing Sciences,63 96 91 2 Nursing Sciences 252
60,95,87,10,252,midwifery,Nursing Sciences,60 95 87 10 Nursing Sciences 252
64,64,56,68,252,midwifery,Nursing Sciences,64 64 56 68 Nursing Sciences 252
84,17,56,95,252,midwifery,Nursing Sciences,84 17 56 95 Nursing Sciences 252
77,40,96,39,252,midwifery,Nursing Sciences,77 40 96 39 Nursing Sciences 252
83,37,72,60,252,midwifery,Nursing Sciences,83 37 72 60 Nursing Sciences 252
39,54,95,64,252,midwifery,Nursing Sciences,39 54 95 64 Nursing Sciences 252
57,48,53,94,252,midwifery,Nursing Sciences,57 48 53 94 Nursing Sciences 252
48,48,61,95,252,midwifery,Nursing Sciences,48 48 61 95 Nursing Sciences 252
67,41,83,61,252,midwifery,Nursing Sciences,67 41 83 61 Nursing Sciences 252
86,6,66,94,252,midwifery,Nursing Sciences,86 6 66 94 Nursing Sciences 252
68,82,98,4,252,midwifery,Nursing Sciences,68 82 98 4 Nursing Sciences 252
36,87,61,68,252,midwifery,Nursing Sciences,36 87 61 68 Nursing Sciences 252
97,2,56,97,252,midwifery,Nursing Sciences,97 2 56 97 Nursing Sciences 252
60,83,80,29,252,midwifery,Nursing Sciences,60 83 80 29 Nursing Sciences 252
100,29,25,98,252,midwifery,Nursing Sciences,100 29 25 98 Nursing Sciences 252
65,83,80,24,252,midwifery,Nursing Sciences,65 83 80 24 Nursing Sciences 252
66,81,21,84,252,midwifery,Nursing Sciences,66 81 21 84 Nursing Sciences 252
98,51,12,91,252,midwifery,Nursing Sciences,98 51 12 91 Nursing Sciences 252
65,33,80,74,252,midwifery,Nursing Sciences,65 33 80 74 Nursing Sciences 252
32,89,44,87,252,midwifery,Nursing Sciences,32 89 44 87 Nursing Sciences 252
93,60,98,1,252,midwifery,Nursing Sciences,93 60 98 1 Nursing Sciences 252
85,37,31,99,252,midwifery,Nursing Sciences,85 37 31 99 Nursing Sciences 252
93,61,98,1,253,midwifery,Nursing Sciences,93 61 98 1 Nursing Sciences 253
81,35,93,44,253,midwifery,Nursing Sciences,81 35 93 44 Nursing Sciences 253
3,64,97,89,253,midwifery,Nursing Sciences,3 64 97 89 Nursing Sciences 253
76,35,87,55,253,midwifery,Nursing Sciences,76 35 87 55 Nursing Sciences 253
83,79,86,5,253,midwifery,Nursing Sciences,83 79 86 5 Nursing Sciences 253
93,59,77,24,253,midwifery,Nursing Sciences,93 59 77 24 Nursing Sciences 253
29,92,48,84,253,midwifery,Nursing Sciences,29 92 48 84 Nursing Sciences 253
79,91,56,27,253,midwifery,Nursing Sciences,79 91 56 27 Nursing Sciences 253
33,90,51,79,253,midwifery,Nursing Sciences,33 90 51 79 Nursing Sciences 253
73,68,81,31,253,midwifery,Nursing Sciences,73 68 81 31 Nursing Sciences 253
51,19,89,94,253,midwifery,Nursing Sciences,51 19 89 94 Nursing Sciences 253
8,60,89,96,253,midwifery,Nursing Sciences,8 60 89 96 Nursing Sciences 253
70,56,73,54,253,midwifery,Nursing Sciences,70 56 73 54 Nursing Sciences 253
73,48,42,90,253,midwifery,Nursing Sciences,73 48 42 90 Nursing Sciences 253
97,67,50,39,253,midwifery,Nursing Sciences,97 67 50 39 Nursing Sciences 253
77,91,55,30,253,midwifery,Nursing Sciences,77 91 55 30 Nursing Sciences 253
84,68,88,13,253,midwifery,Nursing Sciences,84 68 88 13 Nursing Sciences 253
92,66,94,1,253,midwifery,Nursing Sciences,92 66 94 1 Nursing Sciences 253
20,80,84,69,253,midwifery,Nursing Sciences,20 80 84 69 Nursing Sciences 253
17,89,63,84,253,midwifery,Nursing Sciences,17 89 63 84 Nursing Sciences 253
46,64,99,44,253,midwifery,Nursing Sciences,46 64 99 44 Nursing Sciences 253
45,35,75,98,253,midwifery,Nursing Sciences,45 35 75 98 Nursing Sciences 253
99,36,44,74,253,midwifery,Nursing Sciences,99 36 44 74 Nursing Sciences 253
100,47,100,7,254,midwifery,Nursing Sciences,100 47 100 7 Nursing Sciences 254
97,55,98,4,254,midwifery,Nursing Sciences,97 55 98 4 Nursing Sciences 254
60,47,69,78,254,midwifery,Nursing Sciences,60 47 69 78 Nursing Sciences 254
87,30,64,73,254,midwifery,Nursing Sciences,87 30 64 73 Nursing Sciences 254
51,92,39,72,254,midwifery,Nursing Sciences,51 92 39 72 Nursing Sciences 254
71,76,84,23,254,midwifery,Nursing Sciences,71 76 84 23 Nursing Sciences 254
51,56,94,53,254,midwifery,Nursing Sciences,51 56 94 53 Nursing Sciences 254
78,43,61,72,254,midwifery,Nursing Sciences,78 43 61 72 Nursing Sciences 254
63,54,51,86,254,midwifery,Nursing Sciences,63 54 51 86 Nursing Sciences 254
72,50,91,41,254,midwifery,Nursing Sciences,72 50 91 41 Nursing Sciences 254
84,84,79,7,254,midwifery,Nursing Sciences,84 84 79 7 Nursing Sciences 254
69,74,22,89,254,midwifery,Nursing Sciences,69 74 22 89 Nursing Sciences 254
72,95,83,4,254,midwifery,Nursing Sciences,72 95 83 4 Nursing Sciences 254
93,57,99,5,254,midwifery,Nursing Sciences,93 57 99 5 Nursing Sciences 254
54,95,49,56,254,midwifery,Nursing Sciences,54 95 49 56 Nursing Sciences 254
54,53,58,89,254,midwifery,Nursing Sciences,54 53 58 89 Nursing Sciences 254
13,61,88,92,254,midwifery,Nursing Sciences,13 61 88 92 Nursing Sciences 254
18,89,87,60,254,midwifery,Nursing Sciences,18 89 87 60 Nursing Sciences 254
50,86,78,40,254,midwifery,Nursing Sciences,50 86 78 40 Nursing Sciences 254
55,51,91,57,254,midwifery,Nursing Sciences,55 51 91 57 Nursing Sciences 254
43,88,66,58,255,midwifery,Nursing Sciences,43 88 66 58 Nursing Sciences 255
73,93,84,5,255,midwifery,Nursing Sciences,73 93 84 5 Nursing Sciences 255
89,50,60,56,255,midwifery,Nursing Sciences,89 50 60 56 Nursing Sciences 255
32,66,68,89,255,midwifery,Nursing Sciences,32 66 68 89 Nursing Sciences 255
91,79,33,52,255,midwifery,Nursing Sciences,91 79 33 52 Nursing Sciences 255
92,66,74,23,255,midwifery,Nursing Sciences,92 66 74 23 Nursing Sciences 255
53,89,37,76,255,midwifery,Nursing Sciences,53 89 37 76 Nursing Sciences 255
83,54,55,63,255,midwifery,Nursing Sciences,83 54 55 63 Nursing Sciences 255
71,39,75,70,255,midwifery,Nursing Sciences,71 39 75 70 Nursing Sciences 255
94,66,93,2,255,midwifery,Nursing Sciences,94 66 93 2 Nursing Sciences 255
61,78,24,92,255,midwifery,Nursing Sciences,61 78 24 92 Nursing Sciences 255
85,33,83,54,255,midwifery,Nursing Sciences,85 33 83 54 Nursing Sciences 255
89,58,91,17,255,midwifery,Nursing Sciences,89 58 91 17 Nursing Sciences 255
65,88,78,24,255,midwifery,Nursing Sciences,65 88 78 24 Nursing Sciences 255
91,33,84,47,255,midwifery,Nursing Sciences,91 33 84 47 Nursing Sciences 255
89,52,76,38,255,midwifery,Nursing Sciences,89 52 76 38 Nursing Sciences 255
80,40,91,44,255,midwifery,Nursing Sciences,80 40 91 44 Nursing Sciences 255
93,11,95,56,255,midwifery,Nursing Sciences,93 11 95 56 Nursing Sciences 255
80,18,92,65,255,midwifery,Nursing Sciences,80 18 92 65 Nursing Sciences 255
92,20,58,85,255,midwifery,Nursing Sciences,92 20 58 85 Nursing Sciences 255
44,85,32,94,255,midwifery,Nursing Sciences,44 85 32 94 Nursing Sciences 255
14,96,87,58,255,midwifery,Nursing Sciences,14 96 87 58 Nursing Sciences 255
57,49,88,61,255,midwifery,Nursing Sciences,57 49 88 61 Nursing Sciences 255
50,59,91,55,255,midwifery,Nursing Sciences,50 59 91 55 Nursing Sciences 255
59,57,63,76,255,midwifery,Nursing Sciences,59 57 63 76 Nursing Sciences 255
21,75,63,96,255,midwifery,Nursing Sciences,21 75 63 96 Nursing Sciences 255
83,25,79,68,255,midwifery,Nursing Sciences,83 25 79 68 Nursing Sciences 255
58,73,83,41,255,midwifery,Nursing Sciences,58 73 83 41 Nursing Sciences 255
42,98,23,92,255,midwifery,Nursing Sciences,42 98 23 92 Nursing Sciences 255
50,76,50,80,256,metallurgy & material processing,Mines,50 76 50 80 Mines 256
90,26,68,72,256,metallurgy & material processing,Mines,90 26 68 72 Mines 256
85,20,62,89,256,metallurgy & material processing,Mines,85 20 62 89 Mines 256
90,50,69,47,256,metallurgy & material processing,Mines,90 50 69 47 Mines 256
81,69,66,40,256,metallurgy & material processing,Mines,81 69 66 40 Mines 256
77,61,95,23,256,metallurgy & material processing,Mines,77 61 95 23 Mines 256
66,39,61,90,256,metallurgy & material processing,Mines,66 39 61 90 Mines 256
70,50,98,38,256,metallurgy & material processing,Mines,70 50 98 38 Mines 256
74,64,86,32,256,metallurgy & material processing,Mines,74 64 86 32 Mines 256
81,52,75,48,256,metallurgy & material processing,Mines,81 52 75 48 Mines 256
58,100,61,37,256,metallurgy & material processing,Mines,58 100 61 37 Mines 256
64,33,89,70,256,metallurgy & material processing,Mines,64 33 89 70 Mines 256
72,51,83,50,256,metallurgy & material processing,Mines,72 51 83 50 Mines 256
92,65,98,1,256,metallurgy & material processing,Mines,92 65 98 1 Mines 256
30,90,60,76,256,metallurgy & material processing,Mines,30 90 60 76 Mines 256
92,65,96,3,256,metallurgy & material processing,Mines,92 65 96 3 Mines 256
27,79,75,75,256,metallurgy & material processing,Mines,27 79 75 75 Mines 256
64,45,82,65,256,metallurgy & material processing,Mines,64 45 82 65 Mines 256
74,81,82,19,256,metallurgy & material processing,Mines,74 81 82 19 Mines 256
59,63,78,56,256,metallurgy & material processing,Mines,59 63 78 56 Mines 256
52,72,74,58,256,metallurgy & material processing,Mines,52 72 74 58 Mines 256
91,8,62,95,256,metallurgy & material processing,Mines,91 8 62 95 Mines 256
96,85,39,36,256,metallurgy & material processing,Mines,96 85 39 36 Mines 256
91,77,64,24,256,metallurgy & material processing,Mines,91 77 64 24 Mines 256
98,100,55,3,256,metallurgy & material processing,Mines,98 100 55 3 Mines 256
12,91,82,71,256,metallurgy & material processing,Mines,12 91 82 71 Mines 256
89,16,95,56,256,metallurgy & material processing,Mines,89 16 95 56 Mines 256
61,98,93,4,256,metallurgy & material processing,Mines,61 98 93 4 Mines 256
59,52,75,71,257,metallurgy & material processing,Mines,59 52 75 71 Mines 257
79,75,84,19,257,metallurgy & material processing,Mines,79 75 84 19 Mines 257
97,4,75,81,257,metallurgy & material processing,Mines,97 4 75 81 Mines 257
85,36,67,69,257,metallurgy & material processing,Mines,85 36 67 69 Mines 257
32,53,91,81,257,metallurgy & material processing,Mines,32 53 91 81 Mines 257
100,42,88,27,257,metallurgy & material processing,Mines,100 42 88 27 Mines 257
63,46,62,86,257,metallurgy & material processing,Mines,63 46 62 86 Mines 257
89,54,69,45,257,metallurgy & material processing,Mines,89 54 69 45 Mines 257
77,85,86,9,257,metallurgy & material processing,Mines,77 85 86 9 Mines 257
97,47,42,71,257,metallurgy & material processing,Mines,97 47 42 71 Mines 257
49,79,35,94,257,metallurgy & material processing,Mines,49 79 35 94 Mines 257
98,3,100,56,257,metallurgy & material processing,Mines,98 3 100 56 Mines 257
69,29,86,73,257,metallurgy & material processing,Mines,69 29 86 73 Mines 257
82,76,15,84,257,metallurgy & material processing,Mines,82 76 15 84 Mines 257
26,71,90,70,257,metallurgy & material processing,Mines,26 71 90 70 Mines 257
87,46,75,49,257,metallurgy & material processing,Mines,87 46 75 49 Mines 257
88,28,54,87,257,metallurgy & material processing,Mines,88 28 54 87 Mines 257
86,63,91,17,257,metallurgy & material processing,Mines,86 63 91 17 Mines 257
86,86,71,15,258,metallurgy & material processing,Mines,86 86 71 15 Mines 258
69,55,52,82,258,metallurgy & material processing,Mines,69 55 52 82 Mines 258
89,33,79,57,258,metallurgy & material processing,Mines,89 33 79 57 Mines 258
0,83,84,91,258,metallurgy & material processing,Mines,0 83 84 91 Mines 258
75,47,84,52,258,metallurgy & material processing,Mines,75 47 84 52 Mines 258
94,63,97,4,258,metallurgy & material processing,Mines,94 63 97 4 Mines 258
47,85,88,38,258,metallurgy & material processing,Mines,47 85 88 38 Mines 258
11,98,68,81,258,metallurgy & material processing,Mines,11 98 68 81 Mines 258
51,91,72,44,258,metallurgy & material processing,Mines,51 91 72 44 Mines 258
83,28,55,92,258,metallurgy & material processing,Mines,83 28 55 92 Mines 258
95,37,83,43,258,metallurgy & material processing,Mines,95 37 83 43 Mines 258
88,67,90,13,258,metallurgy & material processing,Mines,88 67 90 13 Mines 258
50,98,53,57,258,metallurgy & material processing,Mines,50 98 53 57 Mines 258
13,91,83,71,258,metallurgy & material processing,Mines,13 91 83 71 Mines 258
57,59,48,94,258,metallurgy & material processing,Mines,57 59 48 94 Mines 258
68,42,82,66,258,metallurgy & material processing,Mines,68 42 82 66 Mines 258
79,88,77,14,258,metallurgy & material processing,Mines,79 88 77 14 Mines 258
37,89,39,93,258,metallurgy & material processing,Mines,37 89 39 93 Mines 258
82,24,60,92,258,metallurgy & material processing,Mines,82 24 60 92 Mines 258
85,73,88,12,258,metallurgy & material processing,Mines,85 73 88 12 Mines 258
65,94,3,96,258,metallurgy & material processing,Mines,65 94 3 96 Mines 258
88,66,97,7,258,metallurgy & material processing,Mines,88 66 97 7 Mines 258
25,79,81,73,258,metallurgy & material processing,Mines,25 79 81 73 Mines 258
67,73,46,72,258,metallurgy & material processing,Mines,67 73 46 72 Mines 258
95,32,34,97,258,metallurgy & material processing,Mines,95 32 34 97 Mines 258
75,48,69,67,259,metallurgy & material processing,Mines,75 48 69 67 Mines 259
80,52,34,93,259,metallurgy & material processing,Mines,80 52 34 93 Mines 259
81,49,70,59,259,metallurgy & material processing,Mines,81 49 70 59 Mines 259
62,91,73,33,259,metallurgy & material processing,Mines,62 91 73 33 Mines 259
88,71,89,11,259,metallurgy & material processing,Mines,88 71 89 11 Mines 259
79,45,45,90,259,metallurgy & material processing,Mines,79 45 45 90 Mines 259
51,93,72,43,259,metallurgy & material processing,Mines,51 93 72 43 Mines 259
70,61,65,63,259,metallurgy & material processing,Mines,70 61 65 63 Mines 259
74,37,68,80,259,metallurgy & material processing,Mines,74 37 68 80 Mines 259
97,50,17,95,259,metallurgy & material processing,Mines,97 50 17 95 Mines 259
64,28,76,91,259,metallurgy & material processing,Mines,64 28 76 91 Mines 259
91,77,80,11,259,metallurgy & material processing,Mines,91 77 80 11 Mines 259
78,33,89,59,259,metallurgy & material processing,Mines,78 33 89 59 Mines 259
38,77,82,62,259,metallurgy & material processing,Mines,38 77 82 62 Mines 259
94,22,50,93,259,metallurgy & material processing,Mines,94 22 50 93 Mines 259
38,70,85,66,259,metallurgy & material processing,Mines,38 70 85 66 Mines 259
18,71,87,83,259,metallurgy & material processing,Mines,18 71 87 83 Mines 259
92,84,76,7,259,metallurgy & material processing,Mines,92 84 76 7 Mines 259
21,80,67,91,259,metallurgy & material processing,Mines,21 80 67 91 Mines 259
17,90,97,55,259,metallurgy & material processing,Mines,17 90 97 55 Mines 259
98,50,91,20,259,metallurgy & material processing,Mines,98 50 91 20 Mines 259
42,50,79,88,259,metallurgy & material processing,Mines,42 50 79 88 Mines 259
96,43,92,28,259,metallurgy & material processing,Mines,96 43 92 28 Mines 259
50,55,61,93,259,metallurgy & material processing,Mines,50 55 61 93 Mines 259
27,66,78,88,259,metallurgy & material processing,Mines,27 66 78 88 Mines 259
7,100,86,66,259,metallurgy & material processing,Mines,7 100 86 66 Mines 259
22,72,85,80,259,metallurgy & material processing,Mines,22 72 85 80 Mines 259
18,96,61,84,259,metallurgy & material processing,Mines,18 96 61 84 Mines 259
91,54,83,31,259,metallurgy & material processing,Mines,91 54 83 31 Mines 259
57,67,69,66,259,metallurgy & material processing,Mines,57 67 69 66 Mines 259
88,12,69,90,259,metallurgy & material processing,Mines,88 12 69 90 Mines 259
88,67,95,9,259,metallurgy & material processing,Mines,88 67 95 9 Mines 259
81,32,72,74,259,metallurgy & material processing,Mines,81 32 72 74 Mines 259
82,84,87,6,259,metallurgy & material processing,Mines,82 84 87 6 Mines 259
79,67,78,35,259,metallurgy & material processing,Mines,79 67 78 35 Mines 259
96,62,98,4,260,metallurgy & material processing,Mines,96 62 98 4 Mines 260
78,86,96,0,260,metallurgy & material processing,Mines,78 86 96 0 Mines 260
20,96,88,56,260,metallurgy & material processing,Mines,20 96 88 56 Mines 260
67,42,89,62,260,metallurgy & material processing,Mines,67 42 89 62 Mines 260
57,84,82,37,260,metallurgy & material processing,Mines,57 84 82 37 Mines 260
89,48,70,53,260,metallurgy & material processing,Mines,89 48 70 53 Mines 260
68,93,63,36,260,metallurgy & material processing,Mines,68 93 63 36 Mines 260
70,56,88,46,260,metallurgy & material processing,Mines,70 56 88 46 Mines 260
74,27,82,77,260,metallurgy & material processing,Mines,74 27 82 77 Mines 260
72,28,73,87,260,metallurgy & material processing,Mines,72 28 73 87 Mines 260
57,70,37,96,260,metallurgy & material processing,Mines,57 70 37 96 Mines 260
78,65,36,81,260,metallurgy & material processing,Mines,78 65 36 81 Mines 260
85,89,82,4,260,metallurgy & material processing,Mines,85 89 82 4 Mines 260
76,2,94,88,260,metallurgy & material processing,Mines,76 2 94 88 Mines 260
86,57,43,74,260,metallurgy & material processing,Mines,86 57 43 74 Mines 260
65,62,33,100,260,metallurgy & material processing,Mines,65 62 33 100 Mines 260
46,99,69,46,260,metallurgy & material processing,Mines,46 99 69 46 Mines 260
87,94,28,51,260,metallurgy & material processing,Mines,87 94 28 51 Mines 260
82,64,61,53,260,metallurgy & material processing,Mines,82 64 61 53 Mines 260
75,82,75,28,260,metallurgy & material processing,Mines,75 82 75 28 Mines 260
70,57,71,62,260,metallurgy & material processing,Mines,70 57 71 62 Mines 260
80,51,34,95,260,metallurgy & material processing,Mines,80 51 34 95 Mines 260
70,59,32,99,260,metallurgy & material processing,Mines,70 59 32 99 Mines 260
82,77,88,13,260,metallurgy & material processing,Mines,82 77 88 13 Mines 260
32,64,86,78,260,metallurgy & material processing,Mines,32 64 86 78 Mines 260
66,24,93,77,260,metallurgy & material processing,Mines,66 24 93 77 Mines 260
85,50,58,67,260,metallurgy & material processing,Mines,85 50 58 67 Mines 260
84,97,78,1,260,metallurgy & material processing,Mines,84 97 78 1 Mines 260
49,56,82,73,260,metallurgy & material processing,Mines,49 56 82 73 Mines 260
19,78,76,87,260,metallurgy & material processing,Mines,19 78 76 87 Mines 260
82,66,85,27,260,metallurgy & material processing,Mines,82 66 85 27 Mines 260
93,68,97,3,261,biomedical sciences,Health Sciences,93 68 97 3 Health Sciences 261
67,42,57,95,261,biomedical sciences,Health Sciences,67 42 57 95 Health Sciences 261
67,95,89,10,261,biomedical sciences,Health Sciences,67 95 89 10 Health Sciences 261
93,69,92,7,261,biomedical sciences,Health Sciences,93 69 92 7 Health Sciences 261
72,59,92,38,261,biomedical sciences,Health Sciences,72 59 92 38 Health Sciences 261
71,74,76,40,261,biomedical sciences,Health Sciences,71 74 76 40 Health Sciences 261
44,72,58,87,261,biomedical sciences,Health Sciences,44 72 58 87 Health Sciences 261
46,86,72,57,261,biomedical sciences,Health Sciences,46 86 72 57 Health Sciences 261
98,55,99,9,261,biomedical sciences,Health Sciences,98 55 99 9 Health Sciences 261
73,91,75,22,261,biomedical sciences,Health Sciences,73 91 75 22 Health Sciences 261
58,93,79,31,261,biomedical sciences,Health Sciences,58 93 79 31 Health Sciences 261
63,89,79,30,261,biomedical sciences,Health Sciences,63 89 79 30 Health Sciences 261
96,58,76,31,261,biomedical sciences,Health Sciences,96 58 76 31 Health Sciences 261
38,99,71,53,261,biomedical sciences,Health Sciences,38 99 71 53 Health Sciences 261
99,29,50,83,261,biomedical sciences,Health Sciences,99 29 50 83 Health Sciences 261
76,17,71,97,261,biomedical sciences,Health Sciences,76 17 71 97 Health Sciences 261
89,78,30,64,261,biomedical sciences,Health Sciences,89 78 30 64 Health Sciences 261
16,92,88,65,261,biomedical sciences,Health Sciences,16 92 88 65 Health Sciences 261
88,68,52,53,261,biomedical sciences,Health Sciences,88 68 52 53 Health Sciences 261
26,51,93,91,261,biomedical sciences,Health Sciences,26 51 93 91 Health Sciences 261
76,60,78,47,261,biomedical sciences,Health Sciences,76 60 78 47 Health Sciences 261
90,30,68,73,261,biomedical sciences,Health Sciences,90 30 68 73 Health Sciences 261
92,58,35,76,261,biomedical sciences,Health Sciences,92 58 35 76 Health Sciences 261
86,10,94,71,261,biomedical sciences,Health Sciences,86 10 94 71 Health Sciences 261
39,92,62,69,262,biomedical sciences,Health Sciences,39 92 62 69 Health Sciences 262
67,94,86,15,262,biomedical sciences,Health Sciences,67 94 86 15 Health Sciences 262
22,100,60,80,262,biomedical sciences,Health Sciences,22 100 60 80 Health Sciences 262
81,57,79,45,262,biomedical sciences,Health Sciences,81 57 79 45 Health Sciences 262
39,79,73,71,262,biomedical sciences,Health Sciences,39 79 73 71 Health Sciences 262
61,23,80,98,262,biomedical sciences,Health Sciences,61 23 80 98 Health Sciences 262
38,54,95,75,262,biomedical sciences,Health Sciences,38 54 95 75 Health Sciences 262
19,94,71,78,262,biomedical sciences,Health Sciences,19 94 71 78 Health Sciences 262
56,52,77,77,262,biomedical sciences,Health Sciences,56 52 77 77 Health Sciences 262
35,88,76,63,262,biomedical sciences,Health Sciences,35 88 76 63 Health Sciences 262
77,99,68,18,262,biomedical sciences,Health Sciences,77 99 68 18 Health Sciences 262
50,88,66,58,262,biomedical sciences,Health Sciences,50 88 66 58 Health Sciences 262
100,4,72,86,262,biomedical sciences,Health Sciences,100 4 72 86 Health Sciences 262
88,89,43,42,262,biomedical sciences,Health Sciences,88 89 43 42 Health Sciences 262
48,33,84,97,262,biomedical sciences,Health Sciences,48 33 84 97 Health Sciences 262
59,16,88,99,262,biomedical sciences,Health Sciences,59 16 88 99 Health Sciences 262
63,63,77,59,262,biomedical sciences,Health Sciences,63 63 77 59 Health Sciences 262
91,76,93,2,262,biomedical sciences,Health Sciences,91 76 93 2 Health Sciences 262
88,57,81,36,262,biomedical sciences,Health Sciences,88 57 81 36 Health Sciences 262
94,62,81,25,262,biomedical sciences,Health Sciences,94 62 81 25 Health Sciences 262
67,56,59,80,262,biomedical sciences,Health Sciences,67 56 59 80 Health Sciences 262
77,28,91,66,262,biomedical sciences,Health Sciences,77 28 91 66 Health Sciences 262
66,54,82,60,262,biomedical sciences,Health Sciences,66 54 82 60 Health Sciences 262
99,50,93,20,262,biomedical sciences,Health Sciences,99 50 93 20 Health Sciences 262
76,63,100,24,263,biomedical sciences,Health Sciences,76 63 100 24 Health Sciences 263
70,35,99,59,263,biomedical sciences,Health Sciences,70 35 99 59 Health Sciences 263
94,81,87,1,263,biomedical sciences,Health Sciences,94 81 87 1 Health Sciences 263
79,91,53,40,263,biomedical sciences,Health Sciences,79 91 53 40 Health Sciences 263
69,88,68,38,263,biomedical sciences,Health Sciences,69 88 68 38 Health Sciences 263
65,70,43,85,263,biomedical sciences,Health Sciences,65 70 43 85 Health Sciences 263
52,39,90,82,263,biomedical sciences,Health Sciences,52 39 90 82 Health Sciences 263
24,71,83,85,263,biomedical sciences,Health Sciences,24 71 83 85 Health Sciences 263
37,64,82,80,263,biomedical sciences,Health Sciences,37 64 82 80 Health Sciences 263
26,89,78,70,263,biomedical sciences,Health Sciences,26 89 78 70 Health Sciences 263
87,80,92,4,263,biomedical sciences,Health Sciences,87 80 92 4 Health Sciences 263
90,73,62,38,263,biomedical sciences,Health Sciences,90 73 62 38 Health Sciences 263
94,60,64,45,263,biomedical sciences,Health Sciences,94 60 64 45 Health Sciences 263
83,54,87,39,263,biomedical sciences,Health Sciences,83 54 87 39 Health Sciences 263
91,70,97,5,263,biomedical sciences,Health Sciences,91 70 97 5 Health Sciences 263
86,73,93,11,263,biomedical sciences,Health Sciences,86 73 93 11 Health Sciences 263
77,42,87,57,263,biomedical sciences,Health Sciences,77 42 87 57 Health Sciences 263
94,50,76,43,263,biomedical sciences,Health Sciences,94 50 76 43 Health Sciences 263
77,71,90,25,263,biomedical sciences,Health Sciences,77 71 90 25 Health Sciences 263
5,73,91,94,263,biomedical sciences,Health Sciences,5 73 91 94 Health Sciences 263
79,42,69,73,263,biomedical sciences,Health Sciences,79 42 69 73 Health Sciences 263
98,12,54,99,263,biomedical sciences,Health Sciences,98 12 54 99 Health Sciences 263
96,19,55,94,264,biomedical sciences,Health Sciences,96 19 55 94 Health Sciences 264
70,75,97,22,264,biomedical sciences,Health Sciences,70 75 97 22 Health Sciences 264
39,74,84,67,264,biomedical sciences,Health Sciences,39 74 84 67 Health Sciences 264
89,27,93,55,264,biomedical sciences,Health Sciences,89 27 93 55 Health Sciences 264
73,58,84,49,264,biomedical sciences,Health Sciences,73 58 84 49 Health Sciences 264
84,68,86,26,264,biomedical sciences,Health Sciences,84 68 86 26 Health Sciences 264
51,71,51,91,264,biomedical sciences,Health Sciences,51 71 51 91 Health Sciences 264
87,42,41,94,264,biomedical sciences,Health Sciences,87 42 41 94 Health Sciences 264
84,85,60,35,264,biomedical sciences,Health Sciences,84 85 60 35 Health Sciences 264
53,50,95,66,264,biomedical sciences,Health Sciences,53 50 95 66 Health Sciences 264
88,88,8,80,264,biomedical sciences,Health Sciences,88 88 8 80 Health Sciences 264
90,91,29,54,264,biomedical sciences,Health Sciences,90 91 29 54 Health Sciences 264
94,21,57,92,264,biomedical sciences,Health Sciences,94 21 57 92 Health Sciences 264
27,63,79,95,264,biomedical sciences,Health Sciences,27 63 79 95 Health Sciences 264
87,82,75,20,264,biomedical sciences,Health Sciences,87 82 75 20 Health Sciences 264
88,75,90,11,264,biomedical sciences,Health Sciences,88 75 90 11 Health Sciences 264
46,64,95,59,264,biomedical sciences,Health Sciences,46 64 95 59 Health Sciences 264
86,28,100,50,264,biomedical sciences,Health Sciences,86 28 100 50 Health Sciences 264
89,34,42,99,264,biomedical sciences,Health Sciences,89 34 42 99 Health Sciences 264
98,50,91,25,264,biomedical sciences,Health Sciences,98 50 91 25 Health Sciences 264
78,87,49,50,264,biomedical sciences,Health Sciences,78 87 49 50 Health Sciences 264
48,73,55,88,264,biomedical sciences,Health Sciences,48 73 55 88 Health Sciences 264
98,76,15,76,265,biomedical sciences,Health Sciences,98 76 15 76 Health Sciences 265
58,71,57,79,265,biomedical sciences,Health Sciences,58 71 57 79 Health Sciences 265
82,87,70,26,265,biomedical sciences,Health Sciences,82 87 70 26 Health Sciences 265
80,55,90,40,265,biomedical sciences,Health Sciences,80 55 90 40 Health Sciences 265
38,80,59,88,265,biomedical sciences,Health Sciences,38 80 59 88 Health Sciences 265
80,47,74,64,265,biomedical sciences,Health Sciences,80 47 74 64 Health Sciences 265
86,65,88,26,265,biomedical sciences,Health Sciences,86 65 88 26 Health Sciences 265
56,63,78,68,265,biomedical sciences,Health Sciences,56 63 78 68 Health Sciences 265
91,77,8,89,265,biomedical sciences,Health Sciences,91 77 8 89 Health Sciences 265
99,28,48,90,265,biomedical sciences,Health Sciences,99 28 48 90 Health Sciences 265
92,74,17,82,265,biomedical sciences,Health Sciences,92 74 17 82 Health Sciences 265
89,72,68,36,265,biomedical sciences,Health Sciences,89 72 68 36 Health Sciences 265
11,88,80,86,265,biomedical sciences,Health Sciences,11 88 80 86 Health Sciences 265
77,94,91,3,265,biomedical sciences,Health Sciences,77 94 91 3 Health Sciences 265
57,43,75,90,265,biomedical sciences,Health Sciences,57 43 75 90 Health Sciences 265
52,90,88,35,265,biomedical sciences,Health Sciences,52 90 88 35 Health Sciences 265
56,57,85,67,265,biomedical sciences,Health Sciences,56 57 85 67 Health Sciences 265
25,93,92,55,265,biomedical sciences,Health Sciences,25 93 92 55 Health Sciences 265
83,60,90,32,265,biomedical sciences,Health Sciences,83 60 90 32 Health Sciences 265
74,94,94,3,265,biomedical sciences,Health Sciences,74 94 94 3 Health Sciences 265
87,78,14,86,265,biomedical sciences,Health Sciences,87 78 14 86 Health Sciences 265
44,68,95,58,265,biomedical sciences,Health Sciences,44 68 95 58 Health Sciences 265
99,91,27,48,265,biomedical sciences,Health Sciences,99 91 27 48 Health Sciences 265
80,58,52,75,265,biomedical sciences,Health Sciences,80 58 52 75 Health Sciences 265
68,37,80,80,265,biomedical sciences,Health Sciences,68 37 80 80 Health Sciences 265
45,88,90,43,266,soil sciences,Agricultural Sciences,45 88 90 43 Agricultural Sciences 266
58,62,76,70,266,soil sciences,Agricultural Sciences,58 62 76 70 Agricultural Sciences 266
21,79,76,90,266,soil sciences,Agricultural Sciences,21 79 76 90 Agricultural Sciences 266
34,48,93,91,266,soil sciences,Agricultural Sciences,34 48 93 91 Agricultural Sciences 266
61,95,84,26,266,soil sciences,Agricultural Sciences,61 95 84 26 Agricultural Sciences 266
92,42,53,79,266,soil sciences,Agricultural Sciences,92 42 53 79 Agricultural Sciences 266
78,99,71,18,266,soil sciences,Agricultural Sciences,78 99 71 18 Agricultural Sciences 266
88,37,51,90,266,soil sciences,Agricultural Sciences,88 37 51 90 Agricultural Sciences 266
78,56,79,53,266,soil sciences,Agricultural Sciences,78 56 79 53 Agricultural Sciences 266
79,7,85,95,266,soil sciences,Agricultural Sciences,79 7 85 95 Agricultural Sciences 266
66,87,97,16,266,soil sciences,Agricultural Sciences,66 87 97 16 Agricultural Sciences 266
75,99,85,7,266,soil sciences,Agricultural Sciences,75 99 85 7 Agricultural Sciences 266
73,97,88,8,266,soil sciences,Agricultural Sciences,73 97 88 8 Agricultural Sciences 266
84,72,94,16,266,soil sciences,Agricultural Sciences,84 72 94 16 Agricultural Sciences 266
62,84,95,25,266,soil sciences,Agricultural Sciences,62 84 95 25 Agricultural Sciences 266
50,97,74,45,266,soil sciences,Agricultural Sciences,50 97 74 45 Agricultural Sciences 266
45,83,75,63,266,soil sciences,Agricultural Sciences,45 83 75 63 Agricultural Sciences 266
93,76,39,58,266,soil sciences,Agricultural Sciences,93 76 39 58 Agricultural Sciences 266
59,83,85,39,266,soil sciences,Agricultural Sciences,59 83 85 39 Agricultural Sciences 266
91,66,53,56,266,soil sciences,Agricultural Sciences,91 66 53 56 Agricultural Sciences 266
76,92,84,14,266,soil sciences,Agricultural Sciences,76 92 84 14 Agricultural Sciences 266
81,97,23,65,266,soil sciences,Agricultural Sciences,81 97 23 65 Agricultural Sciences 266
80,33,57,97,267,soil sciences,Agricultural Sciences,80 33 57 97 Agricultural Sciences 267
94,92,66,15,267,soil sciences,Agricultural Sciences,94 92 66 15 Agricultural Sciences 267
85,92,73,17,267,soil sciences,Agricultural Sciences,85 92 73 17 Agricultural Sciences 267
74,88,73,32,267,soil sciences,Agricultural Sciences,74 88 73 32 Agricultural Sciences 267
74,22,90,81,267,soil sciences,Agricultural Sciences,74 22 90 81 Agricultural Sciences 267
50,49,73,95,267,soil sciences,Agricultural Sciences,50 49 73 95 Agricultural Sciences 267
63,81,86,37,267,soil sciences,Agricultural Sciences,63 81 86 37 Agricultural Sciences 267
88,77,75,27,267,soil sciences,Agricultural Sciences,88 77 75 27 Agricultural Sciences 267
86,92,49,40,267,soil sciences,Agricultural Sciences,86 92 49 40 Agricultural Sciences 267
97,58,96,16,267,soil sciences,Agricultural Sciences,97 58 96 16 Agricultural Sciences 267
75,93,90,9,267,soil sciences,Agricultural Sciences,75 93 90 9 Agricultural Sciences 267
86,90,70,21,267,soil sciences,Agricultural Sciences,86 90 70 21 Agricultural Sciences 267
61,69,43,94,267,soil sciences,Agricultural Sciences,61 69 43 94 Agricultural Sciences 267
57,89,39,82,267,soil sciences,Agricultural Sciences,57 89 39 82 Agricultural Sciences 267
89,62,77,39,267,soil sciences,Agricultural Sciences,89 62 77 39 Agricultural Sciences 267
73,2,97,95,267,soil sciences,Agricultural Sciences,73 2 97 95 Agricultural Sciences 267
93,20,66,88,267,soil sciences,Agricultural Sciences,93 20 66 88 Agricultural Sciences 267
67,88,46,66,267,soil sciences,Agricultural Sciences,67 88 46 66 Agricultural Sciences 267
68,59,55,85,267,soil sciences,Agricultural Sciences,68 59 55 85 Agricultural Sciences 267
94,77,96,1,268,soil sciences,Agricultural Sciences,94 77 96 1 Agricultural Sciences 268
73,71,54,70,268,soil sciences,Agricultural Sciences,73 71 54 70 Agricultural Sciences 268
75,88,71,34,268,soil sciences,Agricultural Sciences,75 88 71 34 Agricultural Sciences 268
91,54,29,94,268,soil sciences,Agricultural Sciences,91 54 29 94 Agricultural Sciences 268
99,50,90,29,268,soil sciences,Agricultural Sciences,99 50 90 29 Agricultural Sciences 268
56,30,96,86,268,soil sciences,Agricultural Sciences,56 30 96 86 Agricultural Sciences 268
98,74,94,2,268,soil sciences,Agricultural Sciences,98 74 94 2 Agricultural Sciences 268
88,74,23,83,268,soil sciences,Agricultural Sciences,88 74 23 83 Agricultural Sciences 268
22,80,98,68,268,soil sciences,Agricultural Sciences,22 80 98 68 Agricultural Sciences 268
94,64,50,60,268,soil sciences,Agricultural Sciences,94 64 50 60 Agricultural Sciences 268
98,12,91,67,268,soil sciences,Agricultural Sciences,98 12 91 67 Agricultural Sciences 268
84,19,65,100,268,soil sciences,Agricultural Sciences,84 19 65 100 Agricultural Sciences 268
94,39,89,46,268,soil sciences,Agricultural Sciences,94 39 89 46 Agricultural Sciences 268
57,77,68,66,268,soil sciences,Agricultural Sciences,57 77 68 66 Agricultural Sciences 268
93,68,95,12,268,soil sciences,Agricultural Sciences,93 68 95 12 Agricultural Sciences 268
94,72,100,2,268,soil sciences,Agricultural Sciences,94 72 100 2 Agricultural Sciences 268
74,71,72,51,268,soil sciences,Agricultural Sciences,74 71 72 51 Agricultural Sciences 268
82,93,85,8,268,soil sciences,Agricultural Sciences,82 93 85 8 Agricultural Sciences 268
74,71,53,70,268,soil sciences,Agricultural Sciences,74 71 53 70 Agricultural Sciences 268
78,50,97,43,268,soil sciences,Agricultural Sciences,78 50 97 43 Agricultural Sciences 268
93,99,69,7,268,soil sciences,Agricultural Sciences,93 99 69 7 Agricultural Sciences 268
69,57,80,62,268,soil sciences,Agricultural Sciences,69 57 80 62 Agricultural Sciences 268
84,24,89,71,268,soil sciences,Agricultural Sciences,84 24 89 71 Agricultural Sciences 268
84,65,47,72,268,soil sciences,Agricultural Sciences,84 65 47 72 Agricultural Sciences 268
88,76,37,67,268,soil sciences,Agricultural Sciences,88 76 37 67 Agricultural Sciences 268
67,99,66,36,268,soil sciences,Agricultural Sciences,67 99 66 36 Agricultural Sciences 268
83,74,89,22,268,soil sciences,Agricultural Sciences,83 74 89 22 Agricultural Sciences 268
90,77,96,5,268,soil sciences,Agricultural Sciences,90 77 96 5 Agricultural Sciences 268
99,46,89,34,268,soil sciences,Agricultural Sciences,99 46 89 34 Agricultural Sciences 268
48,76,89,56,269,soil sciences,Agricultural Sciences,48 76 89 56 Agricultural Sciences 269
95,64,71,39,269,soil sciences,Agricultural Sciences,95 64 71 39 Agricultural Sciences 269
56,75,77,61,269,soil sciences,Agricultural Sciences,56 75 77 61 Agricultural Sciences 269
56,61,62,90,269,soil sciences,Agricultural Sciences,56 61 62 90 Agricultural Sciences 269
95,37,77,60,269,soil sciences,Agricultural Sciences,95 37 77 60 Agricultural Sciences 269
50,50,89,80,269,soil sciences,Agricultural Sciences,50 50 89 80 Agricultural Sciences 269
95,11,86,77,269,soil sciences,Agricultural Sciences,95 11 86 77 Agricultural Sciences 269
99,52,39,79,269,soil sciences,Agricultural Sciences,99 52 39 79 Agricultural Sciences 269
82,74,67,46,269,soil sciences,Agricultural Sciences,82 74 67 46 Agricultural Sciences 269
26,79,69,95,269,soil sciences,Agricultural Sciences,26 79 69 95 Agricultural Sciences 269
65,85,54,65,269,soil sciences,Agricultural Sciences,65 85 54 65 Agricultural Sciences 269
83,39,99,48,269,soil sciences,Agricultural Sciences,83 39 99 48 Agricultural Sciences 269
78,92,72,27,269,soil sciences,Agricultural Sciences,78 92 72 27 Agricultural Sciences 269
80,100,36,53,269,soil sciences,Agricultural Sciences,80 100 36 53 Agricultural Sciences 269
67,65,71,66,269,soil sciences,Agricultural Sciences,67 65 71 66 Agricultural Sciences 269
95,7,76,91,269,soil sciences,Agricultural Sciences,95 7 76 91 Agricultural Sciences 269
91,94,20,64,269,soil sciences,Agricultural Sciences,91 94 20 64 Agricultural Sciences 269
81,80,96,12,269,soil sciences,Agricultural Sciences,81 80 96 12 Agricultural Sciences 269
65,92,51,61,269,soil sciences,Agricultural Sciences,65 92 51 61 Agricultural Sciences 269
84,91,79,15,269,soil sciences,Agricultural Sciences,84 91 79 15 Agricultural Sciences 269
82,85,31,71,269,soil sciences,Agricultural Sciences,82 85 31 71 Agricultural Sciences 269
62,84,27,97,270,soil sciences,Agricultural Sciences,62 84 27 97 Agricultural Sciences 270
58,96,65,51,270,soil sciences,Agricultural Sciences,58 96 65 51 Agricultural Sciences 270
74,87,53,56,270,soil sciences,Agricultural Sciences,74 87 53 56 Agricultural Sciences 270
88,85,94,3,270,soil sciences,Agricultural Sciences,88 85 94 3 Agricultural Sciences 270
64,43,75,88,270,soil sciences,Agricultural Sciences,64 43 75 88 Agricultural Sciences 270
98,99,59,14,270,soil sciences,Agricultural Sciences,98 99 59 14 Agricultural Sciences 270
35,99,38,98,270,soil sciences,Agricultural Sciences,35 99 38 98 Agricultural Sciences 270
91,81,92,6,270,soil sciences,Agricultural Sciences,91 81 92 6 Agricultural Sciences 270
47,64,92,67,270,soil sciences,Agricultural Sciences,47 64 92 67 Agricultural Sciences 270
58,88,41,83,270,soil sciences,Agricultural Sciences,58 88 41 83 Agricultural Sciences 270
76,64,75,55,270,soil sciences,Agricultural Sciences,76 64 75 55 Agricultural Sciences 270
39,35,98,98,270,soil sciences,Agricultural Sciences,39 35 98 98 Agricultural Sciences 270
99,69,29,73,270,soil sciences,Agricultural Sciences,99 69 29 73 Agricultural Sciences 270
25,93,95,57,270,soil sciences,Agricultural Sciences,25 93 95 57 Agricultural Sciences 270
76,67,85,42,270,soil sciences,Agricultural Sciences,76 67 85 42 Agricultural Sciences 270
82,39,85,64,270,soil sciences,Agricultural Sciences,82 39 85 64 Agricultural Sciences 270
95,60,98,17,270,soil sciences,Agricultural Sciences,95 60 98 17 Agricultural Sciences 270
87,74,98,11,270,soil sciences,Agricultural Sciences,87 74 98 11 Agricultural Sciences 270
73,79,82,37,271,geomatic engineering,Engineering,73 79 82 37 Engineering 271
71,68,83,49,271,geomatic engineering,Engineering,71 68 83 49 Engineering 271
74,98,94,5,271,geomatic engineering,Engineering,74 98 94 5 Engineering 271
82,50,62,77,271,geomatic engineering,Engineering,82 50 62 77 Engineering 271
92,80,99,0,271,geomatic engineering,Engineering,92 80 99 0 Engineering 271
29,72,82,88,271,geomatic engineering,Engineering,29 72 82 88 Engineering 271
74,79,35,83,271,geomatic engineering,Engineering,74 79 35 83 Engineering 271
63,53,98,57,271,geomatic engineering,Engineering,63 53 98 57 Engineering 271
99,0,74,98,271,geomatic engineering,Engineering,99 0 74 98 Engineering 271
91,88,40,52,271,geomatic engineering,Engineering,91 88 40 52 Engineering 271
72,48,56,95,271,geomatic engineering,Engineering,72 48 56 95 Engineering 271
67,61,84,59,271,geomatic engineering,Engineering,67 61 84 59 Engineering 271
85,59,49,78,271,geomatic engineering,Engineering,85 59 49 78 Engineering 271
63,76,63,69,271,geomatic engineering,Engineering,63 76 63 69 Engineering 271
80,1,95,95,271,geomatic engineering,Engineering,80 1 95 95 Engineering 271
60,84,60,67,271,geomatic engineering,Engineering,60 84 60 67 Engineering 271
87,24,86,74,271,geomatic engineering,Engineering,87 24 86 74 Engineering 271
75,98,95,4,272,geomatic engineering,Engineering,75 98 95 4 Engineering 272
96,0,82,94,272,geomatic engineering,Engineering,96 0 82 94 Engineering 272
53,77,72,70,272,geomatic engineering,Engineering,53 77 72 70 Engineering 272
90,50,94,38,272,geomatic engineering,Engineering,90 50 94 38 Engineering 272
90,50,88,44,272,geomatic engineering,Engineering,90 50 88 44 Engineering 272
68,68,71,65,272,geomatic engineering,Engineering,68 68 71 65 Engineering 272
91,91,64,26,272,geomatic engineering,Engineering,91 91 64 26 Engineering 272
99,52,94,27,272,geomatic engineering,Engineering,99 52 94 27 Engineering 272
62,76,50,84,272,geomatic engineering,Engineering,62 76 50 84 Engineering 272
4,70,98,100,272,geomatic engineering,Engineering,4 70 98 100 Engineering 272
25,88,70,89,272,geomatic engineering,Engineering,25 88 70 89 Engineering 272
33,93,65,81,272,geomatic engineering,Engineering,33 93 65 81 Engineering 272
43,70,73,86,272,geomatic engineering,Engineering,43 70 73 86 Engineering 272
92,66,100,14,272,geomatic engineering,Engineering,92 66 100 14 Engineering 272
100,58,34,80,272,geomatic engineering,Engineering,100 58 34 80 Engineering 272
64,65,76,67,272,geomatic engineering,Engineering,64 65 76 67 Engineering 272
23,87,79,83,272,geomatic engineering,Engineering,23 87 79 83 Engineering 272
75,96,94,7,272,geomatic engineering,Engineering,75 96 94 7 Engineering 272
98,20,70,84,272,geomatic engineering,Engineering,98 20 70 84 Engineering 272
63,98,75,36,272,geomatic engineering,Engineering,63 98 75 36 Engineering 272
57,63,100,53,273,geomatic engineering,Engineering,57 63 100 53 Engineering 273
96,38,67,72,273,geomatic engineering,Engineering,96 38 67 72 Engineering 273
40,80,83,70,273,geomatic engineering,Engineering,40 80 83 70 Engineering 273
99,49,87,38,273,geomatic engineering,Engineering,99 49 87 38 Engineering 273
64,49,77,83,273,geomatic engineering,Engineering,64 49 77 83 Engineering 273
89,56,58,70,273,geomatic engineering,Engineering,89 56 58 70 Engineering 273
99,85,82,7,273,geomatic engineering,Engineering,99 85 82 7 Engineering 273
58,99,81,35,273,geomatic engineering,Engineering,58 99 81 35 Engineering 273
31,84,89,69,273,geomatic engineering,Engineering,31 84 89 69 Engineering 273
19,59,96,99,273,geomatic engineering,Engineering,19 59 96 99 Engineering 273
72,34,69,98,273,geomatic engineering,Engineering,72 34 69 98 Engineering 273
42,50,90,91,273,geomatic engineering,Engineering,42 50 90 91 Engineering 273
29,76,92,76,273,geomatic engineering,Engineering,29 76 92 76 Engineering 273
91,42,46,94,273,geomatic engineering,Engineering,91 42 46 94 Engineering 273
94,75,42,62,273,geomatic engineering,Engineering,94 75 42 62 Engineering 273
74,45,70,84,273,geomatic engineering,Engineering,74 45 70 84 Engineering 273
99,93,27,54,273,geomatic engineering,Engineering,99 93 27 54 Engineering 273
60,82,80,51,273,geomatic engineering,Engineering,60 82 80 51 Engineering 273
88,77,83,25,273,geomatic engineering,Engineering,88 77 83 25 Engineering 273
75,72,65,61,273,geomatic engineering,Engineering,75 72 65 61 Engineering 273
76,4,99,94,273,geomatic engineering,Engineering,76 4 99 94 Engineering 273
79,52,49,94,274,geomatic engineering,Engineering,79 52 49 94 Engineering 274
51,99,43,81,274,geomatic engineering,Engineering,51 99 43 81 Engineering 274
79,38,65,92,274,geomatic engineering,Engineering,79 38 65 92 Engineering 274
89,21,64,100,274,geomatic engineering,Engineering,89 21 64 100 Engineering 274
97,33,85,59,274,geomatic engineering,Engineering,97 33 85 59 Engineering 274
86,52,82,54,274,geomatic engineering,Engineering,86 52 82 54 Engineering 274
70,83,92,29,274,geomatic engineering,Engineering,70 83 92 29 Engineering 274
34,80,97,63,274,geomatic engineering,Engineering,34 80 97 63 Engineering 274
95,80,98,1,274,geomatic engineering,Engineering,95 80 98 1 Engineering 274
66,75,43,90,274,geomatic engineering,Engineering,66 75 43 90 Engineering 274
90,76,93,15,274,geomatic engineering,Engineering,90 76 93 15 Engineering 274
81,32,79,82,274,geomatic engineering,Engineering,81 32 79 82 Engineering 274
83,97,20,74,274,geomatic engineering,Engineering,83 97 20 74 Engineering 274
93,87,93,1,274,geomatic engineering,Engineering,93 87 93 1 Engineering 274
36,91,75,72,274,geomatic engineering,Engineering,36 91 75 72 Engineering 274
93,84,97,0,274,geomatic engineering,Engineering,93 84 97 0 Engineering 274
98,43,49,84,274,geomatic engineering,Engineering,98 43 49 84 Engineering 274
86,59,38,91,274,geomatic engineering,Engineering,86 59 38 91 Engineering 274
92,63,87,33,275,geomatic engineering,Engineering,92 63 87 33 Engineering 275
77,80,70,48,275,geomatic engineering,Engineering,77 80 70 48 Engineering 275
76,98,94,7,275,geomatic engineering,Engineering,76 98 94 7 Engineering 275
79,97,92,7,275,geomatic engineering,Engineering,79 97 92 7 Engineering 275
76,74,26,99,275,geomatic engineering,Engineering,76 74 26 99 Engineering 275
64,83,32,96,275,geomatic engineering,Engineering,64 83 32 96 Engineering 275
90,77,33,75,275,geomatic engineering,Engineering,90 77 33 75 Engineering 275
94,64,46,71,275,geomatic engineering,Engineering,94 64 46 71 Engineering 275
87,94,90,4,275,geomatic engineering,Engineering,87 94 90 4 Engineering 275
64,85,93,33,275,geomatic engineering,Engineering,64 85 93 33 Engineering 275
88,96,30,61,275,geomatic engineering,Engineering,88 96 30 61 Engineering 275
90,91,69,25,275,geomatic engineering,Engineering,90 91 69 25 Engineering 275
96,16,70,93,275,geomatic engineering,Engineering,96 16 70 93 Engineering 275
92,68,21,94,275,geomatic engineering,Engineering,92 68 21 94 Engineering 275
38,91,97,49,275,geomatic engineering,Engineering,38 91 97 49 Engineering 275
21,98,71,85,275,geomatic engineering,Engineering,21 98 71 85 Engineering 275
87,64,90,34,275,geomatic engineering,Engineering,87 64 90 34 Engineering 275
66,89,87,33,275,geomatic engineering,Engineering,66 89 87 33 Engineering 275
81,89,95,10,275,geomatic engineering,Engineering,81 89 95 10 Engineering 275
13,97,75,90,275,geomatic engineering,Engineering,13 97 75 90 Engineering 275
40,84,91,60,275,geomatic engineering,Engineering,40 84 91 60 Engineering 275
92,54,76,53,275,geomatic engineering,Engineering,92 54 76 53 Engineering 275
21,95,87,72,275,geomatic engineering,Engineering,21 95 87 72 Engineering 275
85,68,95,28,276,biology,Natural Sciences,85 68 95 28 Natural Sciences 276
96,71,88,21,276,biology,Natural Sciences,96 71 88 21 Natural Sciences 276
16,95,88,77,276,biology,Natural Sciences,16 95 88 77 Natural Sciences 276
86,48,86,56,276,biology,Natural Sciences,86 48 86 56 Natural Sciences 276
92,79,99,6,276,biology,Natural Sciences,92 79 99 6 Natural Sciences 276
92,59,51,74,276,biology,Natural Sciences,92 59 51 74 Natural Sciences 276
36,53,95,92,276,biology,Natural Sciences,36 53 95 92 Natural Sciences 276
79,45,95,57,276,biology,Natural Sciences,79 45 95 57 Natural Sciences 276
94,81,99,2,276,biology,Natural Sciences,94 81 99 2 Natural Sciences 276
73,59,62,82,276,biology,Natural Sciences,73 59 62 82 Natural Sciences 276
64,67,64,81,276,biology,Natural Sciences,64 67 64 81 Natural Sciences 276
78,59,75,64,276,biology,Natural Sciences,78 59 75 64 Natural Sciences 276
84,66,83,43,276,biology,Natural Sciences,84 66 83 43 Natural Sciences 276
76,86,33,82,277,biology,Natural Sciences,76 86 33 82 Natural Sciences 277
90,76,30,81,277,biology,Natural Sciences,90 76 30 81 Natural Sciences 277
80,93,81,23,277,biology,Natural Sciences,80 93 81 23 Natural Sciences 277
46,69,83,79,277,biology,Natural Sciences,46 69 83 79 Natural Sciences 277
53,86,63,75,277,biology,Natural Sciences,53 86 63 75 Natural Sciences 277
85,88,19,85,277,biology,Natural Sciences,85 88 19 85 Natural Sciences 277
75,30,95,77,277,biology,Natural Sciences,75 30 95 77 Natural Sciences 277
84,93,94,6,277,biology,Natural Sciences,84 93 94 6 Natural Sciences 277
60,70,64,83,277,biology,Natural Sciences,60 70 64 83 Natural Sciences 277
80,46,66,85,277,biology,Natural Sciences,80 46 66 85 Natural Sciences 277
98,2,96,81,277,biology,Natural Sciences,98 2 96 81 Natural Sciences 277
82,95,56,44,277,biology,Natural Sciences,82 95 56 44 Natural Sciences 277
86,41,83,67,277,biology,Natural Sciences,86 41 83 67 Natural Sciences 277
97,69,99,12,277,biology,Natural Sciences,97 69 99 12 Natural Sciences 277
93,82,63,39,277,biology,Natural Sciences,93 82 63 39 Natural Sciences 277
88,43,89,57,277,biology,Natural Sciences,88 43 89 57 Natural Sciences 277
52,54,99,73,278,biology,Natural Sciences,52 54 99 73 Natural Sciences 278
100,69,33,76,278,biology,Natural Sciences,100 69 33 76 Natural Sciences 278
64,58,61,95,278,biology,Natural Sciences,64 58 61 95 Natural Sciences 278
55,63,93,67,278,biology,Natural Sciences,55 63 93 67 Natural Sciences 278
99,84,51,44,278,biology,Natural Sciences,99 84 51 44 Natural Sciences 278
85,19,77,97,278,biology,Natural Sciences,85 19 77 97 Natural Sciences 278
91,84,95,8,278,biology,Natural Sciences,91 84 95 8 Natural Sciences 278
51,97,84,46,278,biology,Natural Sciences,51 97 84 46 Natural Sciences 278
62,90,93,33,278,biology,Natural Sciences,62 90 93 33 Natural Sciences 278
95,84,93,6,278,biology,Natural Sciences,95 84 93 6 Natural Sciences 278
92,38,85,63,278,biology,Natural Sciences,92 38 85 63 Natural Sciences 278
92,79,56,51,278,biology,Natural Sciences,92 79 56 51 Natural Sciences 278
86,97,89,6,278,biology,Natural Sciences,86 97 89 6 Natural Sciences 278
46,53,99,80,278,biology,Natural Sciences,46 53 99 80 Natural Sciences 278
50,75,61,92,278,biology,Natural Sciences,50 75 61 92 Natural Sciences 278
67,99,58,54,278,biology,Natural Sciences,67 99 58 54 Natural Sciences 278
50,64,100,65,279,biology,Natural Sciences,50 64 100 65 Natural Sciences 279
80,55,76,68,279,biology,Natural Sciences,80 55 76 68 Natural Sciences 279
52,66,71,90,279,biology,Natural Sciences,52 66 71 90 Natural Sciences 279
50,83,81,65,279,biology,Natural Sciences,50 83 81 65 Natural Sciences 279
84,65,33,97,279,biology,Natural Sciences,84 65 33 97 Natural Sciences 279
83,21,82,93,279,biology,Natural Sciences,83 21 82 93 Natural Sciences 279
94,79,30,76,279,biology,Natural Sciences,94 79 30 76 Natural Sciences 279
76,50,86,67,279,biology,Natural Sciences,76 50 86 67 Natural Sciences 279
83,21,78,97,279,biology,Natural Sciences,83 21 78 97 Natural Sciences 279
97,2,98,82,279,biology,Natural Sciences,97 2 98 82 Natural Sciences 279
94,16,90,79,279,biology,Natural Sciences,94 16 90 79 Natural Sciences 279
90,92,95,2,279,biology,Natural Sciences,90 92 95 2 Natural Sciences 279
61,90,74,54,279,biology,Natural Sciences,61 90 74 54 Natural Sciences 279
92,54,59,74,279,biology,Natural Sciences,92 54 59 74 Natural Sciences 279
84,100,81,14,279,biology,Natural Sciences,84 100 81 14 Natural Sciences 279
33,91,90,65,279,biology,Natural Sciences,33 91 90 65 Natural Sciences 279
84,57,73,66,280,biology,Natural Sciences,84 57 73 66 Natural Sciences 280
76,50,80,74,280,biology,Natural Sciences,76 50 80 74 Natural Sciences 280
93,69,66,52,280,biology,Natural Sciences,93 69 66 52 Natural Sciences 280
47,77,82,74,280,biology,Natural Sciences,47 77 82 74 Natural Sciences 280
93,2,85,100,280,biology,Natural Sciences,93 2 85 100 Natural Sciences 280
64,47,86,83,280,biology,Natural Sciences,64 47 86 83 Natural Sciences 280
73,29,85,93,280,biology,Natural Sciences,73 29 85 93 Natural Sciences 280
97,1,92,90,280,biology,Natural Sciences,97 1 92 90 Natural Sciences 280
86,74,36,84,280,biology,Natural Sciences,86 74 36 84 Natural Sciences 280
66,30,95,89,280,biology,Natural Sciences,66 30 95 89 Natural Sciences 280
78,53,62,87,280,biology,Natural Sciences,78 53 62 87 Natural Sciences 280
18,89,89,84,280,biology,Natural Sciences,18 89 89 84 Natural Sciences 280
87,33,64,96,280,biology,Natural Sciences,87 33 64 96 Natural Sciences 280
78,72,92,38,280,biology,Natural Sciences,78 72 92 38 Natural Sciences 280
72,86,58,64,280,biology,Natural Sciences,72 86 58 64 Natural Sciences 280
82,100,92,6,280,biology,Natural Sciences,82 100 92 6 Natural Sciences 280
95,82,21,82,280,biology,Natural Sciences,95 82 21 82 Natural Sciences 280
90,28,71,91,280,biology,Natural Sciences,90 28 71 91 Natural Sciences 280
85,86,95,14,280,biology,Natural Sciences,85 86 95 14 Natural Sciences 280
89,17,82,93,281,agricultural engineering,Engineering,89 17 82 93 Engineering 281
62,50,80,89,281,agricultural engineering,Engineering,62 50 80 89 Engineering 281
52,46,90,93,281,agricultural engineering,Engineering,52 46 90 93 Engineering 281
82,29,95,75,281,agricultural engineering,Engineering,82 29 95 75 Engineering 281
93,80,56,52,281,agricultural engineering,Engineering,93 80 56 52 Engineering 281
97,68,90,26,281,agricultural engineering,Engineering,97 68 90 26 Engineering 281
60,75,80,66,281,agricultural engineering,Engineering,60 75 80 66 Engineering 281
63,58,62,98,281,agricultural engineering,Engineering,63 58 62 98 Engineering 281
42,82,69,88,281,agricultural engineering,Engineering,42 82 69 88 Engineering 281
94,89,74,24,281,agricultural engineering,Engineering,94 89 74 24 Engineering 281
64,78,62,77,281,agricultural engineering,Engineering,64 78 62 77 Engineering 281
86,96,96,3,281,agricultural engineering,Engineering,86 96 96 3 Engineering 281
92,18,98,73,281,agricultural engineering,Engineering,92 18 98 73 Engineering 281
78,86,91,26,281,agricultural engineering,Engineering,78 86 91 26 Engineering 281
87,84,99,11,281,agricultural engineering,Engineering,87 84 99 11 Engineering 281
60,68,60,94,282,agricultural engineering,Engineering,60 68 60 94 Engineering 282
85,58,99,40,282,agricultural engineering,Engineering,85 58 99 40 Engineering 282
72,87,28,95,282,agricultural engineering,Engineering,72 87 28 95 Engineering 282
98,61,80,43,282,agricultural engineering,Engineering,98 61 80 43 Engineering 282
83,34,70,95,282,agricultural engineering,Engineering,83 34 70 95 Engineering 282
87,50,58,87,282,agricultural engineering,Engineering,87 50 58 87 Engineering 282
20,94,75,93,282,agricultural engineering,Engineering,20 94 75 93 Engineering 282
65,55,72,90,282,agricultural engineering,Engineering,65 55 72 90 Engineering 282
83,96,95,8,282,agricultural engineering,Engineering,83 96 95 8 Engineering 282
68,57,95,62,282,agricultural engineering,Engineering,68 57 95 62 Engineering 282
55,92,88,47,282,agricultural engineering,Engineering,55 92 88 47 Engineering 282
97,64,49,72,282,agricultural engineering,Engineering,97 64 49 72 Engineering 282
53,64,92,73,282,agricultural engineering,Engineering,53 64 92 73 Engineering 282
95,32,89,66,282,agricultural engineering,Engineering,95 32 89 66 Engineering 282
70,71,77,65,283,agricultural engineering,Engineering,70 71 77 65 Engineering 283
95,87,9,92,283,agricultural engineering,Engineering,95 87 9 92 Engineering 283
56,81,52,94,283,agricultural engineering,Engineering,56 81 52 94 Engineering 283
83,99,89,12,283,agricultural engineering,Engineering,83 99 89 12 Engineering 283
71,32,87,93,283,agricultural engineering,Engineering,71 32 87 93 Engineering 283
93,74,66,50,283,agricultural engineering,Engineering,93 74 66 50 Engineering 283
99,91,91,2,283,agricultural engineering,Engineering,99 91 91 2 Engineering 283
88,74,82,39,283,agricultural engineering,Engineering,88 74 82 39 Engineering 283
41,88,61,93,283,agricultural engineering,Engineering,41 88 61 93 Engineering 283
65,78,92,48,283,agricultural engineering,Engineering,65 78 92 48 Engineering 283
86,74,88,35,283,agricultural engineering,Engineering,86 74 88 35 Engineering 283
100,58,70,55,283,agricultural engineering,Engineering,100 58 70 55 Engineering 283
87,84,86,27,284,agricultural engineering,Engineering,87 84 86 27 Engineering 284
92,63,83,46,284,agricultural engineering,Engineering,92 63 83 46 Engineering 284
50,92,88,54,284,agricultural engineering,Engineering,50 92 88 54 Engineering 284
68,45,77,94,284,agricultural engineering,Engineering,68 45 77 94 Engineering 284
88,20,89,87,284,agricultural engineering,Engineering,88 20 89 87 Engineering 284
93,100,83,8,284,agricultural engineering,Engineering,93 100 83 8 Engineering 284
31,66,95,92,284,agricultural engineering,Engineering,31 66 95 92 Engineering 284
94,55,67,68,284,agricultural engineering,Engineering,94 55 67 68 Engineering 284
66,99,63,56,284,agricultural engineering,Engineering,66 99 63 56 Engineering 284
29,97,67,91,284,agricultural engineering,Engineering,29 97 67 91 Engineering 284
42,84,88,70,284,agricultural engineering,Engineering,42 84 88 70 Engineering 284
18,94,92,80,284,agricultural engineering,Engineering,18 94 92 80 Engineering 284
96,85,97,6,284,agricultural engineering,Engineering,96 85 97 6 Engineering 284
55,58,89,82,284,agricultural engineering,Engineering,55 58 89 82 Engineering 284
70,45,92,77,284,agricultural engineering,Engineering,70 45 92 77 Engineering 284
43,94,54,93,284,agricultural engineering,Engineering,43 94 54 93 Engineering 284
70,62,100,52,284,agricultural engineering,Engineering,70 62 100 52 Engineering 284
91,97,31,66,285,agricultural engineering,Engineering,91 97 31 66 Engineering 285
97,50,92,46,285,agricultural engineering,Engineering,97 50 92 46 Engineering 285
69,99,90,27,285,agricultural engineering,Engineering,69 99 90 27 Engineering 285
74,83,40,88,285,agricultural engineering,Engineering,74 83 40 88 Engineering 285
35,93,78,79,285,agricultural engineering,Engineering,35 93 78 79 Engineering 285
91,23,74,97,285,agricultural engineering,Engineering,91 23 74 97 Engineering 285
20,80,90,95,285,agricultural engineering,Engineering,20 80 90 95 Engineering 285
91,94,99,1,285,agricultural engineering,Engineering,91 94 99 1 Engineering 285
77,71,69,68,285,agricultural engineering,Engineering,77 71 69 68 Engineering 285
91,97,95,2,285,agricultural engineering,Engineering,91 97 95 2 Engineering 285
82,51,83,69,285,agricultural engineering,Engineering,82 51 83 69 Engineering 285
75,47,92,71,285,agricultural engineering,Engineering,75 47 92 71 Engineering 285
99,96,90,0,285,agricultural engineering,Engineering,99 96 90 0 Engineering 285
86,23,98,78,285,agricultural engineering,Engineering,86 23 98 78 Engineering 285
95,44,54,92,285,agricultural engineering,Engineering,95 44 54 92 Engineering 285
93,78,43,71,285,agricultural engineering,Engineering,93 78 43 71 Engineering 285
6,87,100,93,286,chemistry,Natural Sciences,6 87 100 93 Natural Sciences 286
88,59,61,78,286,chemistry,Natural Sciences,88 59 61 78 Natural Sciences 286
93,50,92,51,286,chemistry,Natural Sciences,93 50 92 51 Natural Sciences 286
88,91,93,14,286,chemistry,Natural Sciences,88 91 93 14 Natural Sciences 286
73,77,48,88,286,chemistry,Natural Sciences,73 77 48 88 Natural Sciences 286
20,91,80,95,286,chemistry,Natural Sciences,20 91 80 95 Natural Sciences 286
92,4,94,96,286,chemistry,Natural Sciences,92 4 94 96 Natural Sciences 286
99,76,76,35,286,chemistry,Natural Sciences,99 76 76 35 Natural Sciences 286
84,70,48,84,286,chemistry,Natural Sciences,84 70 48 84 Natural Sciences 286
85,74,48,79,286,chemistry,Natural Sciences,85 74 48 79 Natural Sciences 286
50,68,89,79,286,chemistry,Natural Sciences,50 68 89 79 Natural Sciences 286
96,88,94,9,287,chemistry,Natural Sciences,96 88 94 9 Natural Sciences 287
97,78,99,13,287,chemistry,Natural Sciences,97 78 99 13 Natural Sciences 287
78,80,60,69,287,chemistry,Natural Sciences,78 80 60 69 Natural Sciences 287
87,12,93,95,287,chemistry,Natural Sciences,87 12 93 95 Natural Sciences 287
87,99,95,6,287,chemistry,Natural Sciences,87 99 95 6 Natural Sciences 287
55,72,87,73,287,chemistry,Natural Sciences,55 72 87 73 Natural Sciences 287
81,58,96,52,287,chemistry,Natural Sciences,81 58 96 52 Natural Sciences 287
64,85,99,39,287,chemistry,Natural Sciences,64 85 99 39 Natural Sciences 287
77,46,74,90,287,chemistry,Natural Sciences,77 46 74 90 Natural Sciences 287
99,6,96,86,287,chemistry,Natural Sciences,99 6 96 86 Natural Sciences 287
86,25,84,93,288,chemistry,Natural Sciences,86 25 84 93 Natural Sciences 288
83,95,76,34,288,chemistry,Natural Sciences,83 95 76 34 Natural Sciences 288
96,38,58,96,288,chemistry,Natural Sciences,96 38 58 96 Natural Sciences 288
92,78,43,75,288,chemistry,Natural Sciences,92 78 43 75 Natural Sciences 288
99,6,84,99,288,chemistry,Natural Sciences,99 6 84 99 Natural Sciences 288
78,87,98,25,288,chemistry,Natural Sciences,78 87 98 25 Natural Sciences 288
59,91,51,87,288,chemistry,Natural Sciences,59 91 51 87 Natural Sciences 288
64,78,80,66,288,chemistry,Natural Sciences,64 78 80 66 Natural Sciences 288
91,80,88,29,288,chemistry,Natural Sciences,91 80 88 29 Natural Sciences 288
93,79,97,19,288,chemistry,Natural Sciences,93 79 97 19 Natural Sciences 288
75,100,19,94,288,chemistry,Natural Sciences,75 100 19 94 Natural Sciences 288
86,50,93,59,288,chemistry,Natural Sciences,86 50 93 59 Natural Sciences 288
89,91,83,25,288,chemistry,Natural Sciences,89 91 83 25 Natural Sciences 288
83,58,85,63,289,chemistry,Natural Sciences,83 58 85 63 Natural Sciences 289
81,55,92,61,289,chemistry,Natural Sciences,81 55 92 61 Natural Sciences 289
84,66,82,57,289,chemistry,Natural Sciences,84 66 82 57 Natural Sciences 289
63,84,55,87,289,chemistry,Natural Sciences,63 84 55 87 Natural Sciences 289
85,99,87,18,289,chemistry,Natural Sciences,85 99 87 18 Natural Sciences 289
91,95,92,11,289,chemistry,Natural Sciences,91 95 92 11 Natural Sciences 289
43,90,65,91,289,chemistry,Natural Sciences,43 90 65 91 Natural Sciences 289
84,18,94,93,289,chemistry,Natural Sciences,84 18 94 93 Natural Sciences 289
96,75,100,18,289,chemistry,Natural Sciences,96 75 100 18 Natural Sciences 289
39,94,67,89,289,chemistry,Natural Sciences,39 94 67 89 Natural Sciences 289
85,75,87,42,289,chemistry,Natural Sciences,85 75 87 42 Natural Sciences 289
82,39,90,78,289,chemistry,Natural Sciences,82 39 90 78 Natural Sciences 289
99,51,94,46,290,chemistry,Natural Sciences,99 51 94 46 Natural Sciences 290
77,29,95,89,290,chemistry,Natural Sciences,77 29 95 89 Natural Sciences 290
96,32,79,83,290,chemistry,Natural Sciences,96 32 79 83 Natural Sciences 290
93,31,69,97,290,chemistry,Natural Sciences,93 31 69 97 Natural Sciences 290
52,92,52,94,290,chemistry,Natural Sciences,52 92 52 94 Natural Sciences 290
94,97,94,5,290,chemistry,Natural Sciences,94 97 94 5 Natural Sciences 290
85,44,98,63,290,chemistry,Natural Sciences,85 44 98 63 Natural Sciences 290
78,38,94,80,290,chemistry,Natural Sciences,78 38 94 80 Natural Sciences 290
53,78,77,83,291,nursing,Nursing Sciences,53 78 77 83 Nursing Sciences 291
84,48,61,98,291,nursing,Nursing Sciences,84 48 61 98 Nursing Sciences 291
77,51,79,84,291,nursing,Nursing Sciences,77 51 79 84 Nursing Sciences 291
67,90,50,84,291,nursing,Nursing Sciences,67 90 50 84 Nursing Sciences 291
89,26,77,99,291,nursing,Nursing Sciences,89 26 77 99 Nursing Sciences 291
81,88,80,42,291,nursing,Nursing Sciences,81 88 80 42 Nursing Sciences 291
68,96,42,85,291,nursing,Nursing Sciences,68 96 42 85 Nursing Sciences 291
92,98,90,11,291,nursing,Nursing Sciences,92 98 90 11 Nursing Sciences 291
56,86,58,91,291,nursing,Nursing Sciences,56 86 58 91 Nursing Sciences 291
95,96,98,2,291,nursing,Nursing Sciences,95 96 98 2 Nursing Sciences 291
98,90,99,4,291,nursing,Nursing Sciences,98 90 99 4 Nursing Sciences 291
83,50,87,72,292,nursing,Nursing Sciences,83 50 87 72 Nursing Sciences 292
52,60,98,82,292,nursing,Nursing Sciences,52 60 98 82 Nursing Sciences 292
71,57,77,87,292,nursing,Nursing Sciences,71 57 77 87 Nursing Sciences 292
81,85,92,34,292,nursing,Nursing Sciences,81 85 92 34 Nursing Sciences 292
58,56,89,89,292,nursing,Nursing Sciences,58 56 89 89 Nursing Sciences 292
29,94,74,95,292,nursing,Nursing Sciences,29 94 74 95 Nursing Sciences 292
98,93,96,5,292,nursing,Nursing Sciences,98 93 96 5 Nursing Sciences 292
95,95,97,5,292,nursing,Nursing Sciences,95 95 97 5 Nursing Sciences 292
93,85,20,94,292,nursing,Nursing Sciences,93 85 20 94 Nursing Sciences 292
95,45,60,92,292,nursing,Nursing Sciences,95 45 60 92 Nursing Sciences 292
58,69,71,94,292,nursing,Nursing Sciences,58 69 71 94 Nursing Sciences 292
83,58,60,91,292,nursing,Nursing Sciences,83 58 60 91 Nursing Sciences 292
66,70,80,76,292,nursing,Nursing Sciences,66 70 80 76 Nursing Sciences 292
51,88,83,70,292,nursing,Nursing Sciences,51 88 83 70 Nursing Sciences 292
98,95,96,3,292,nursing,Nursing Sciences,98 95 96 3 Nursing Sciences 292
32,83,91,87,293,nursing,Nursing Sciences,32 83 91 87 Nursing Sciences 293
90,33,72,98,293,nursing,Nursing Sciences,90 33 72 98 Nursing Sciences 293
84,55,69,85,293,nursing,Nursing Sciences,84 55 69 85 Nursing Sciences 293
74,70,61,88,293,nursing,Nursing Sciences,74 70 61 88 Nursing Sciences 293
72,54,87,80,293,nursing,Nursing Sciences,72 54 87 80 Nursing Sciences 293
96,62,64,71,293,nursing,Nursing Sciences,96 62 64 71 Nursing Sciences 293
99,93,99,2,293,nursing,Nursing Sciences,99 93 99 2 Nursing Sciences 293
97,62,90,44,293,nursing,Nursing Sciences,97 62 90 44 Nursing Sciences 293
74,78,95,46,293,nursing,Nursing Sciences,74 78 95 46 Nursing Sciences 293
77,69,72,75,293,nursing,Nursing Sciences,77 69 72 75 Nursing Sciences 293
90,63,76,64,293,nursing,Nursing Sciences,90 63 76 64 Nursing Sciences 293
89,99,97,8,293,nursing,Nursing Sciences,89 99 97 8 Nursing Sciences 293
90,54,52,97,293,nursing,Nursing Sciences,90 54 52 97 Nursing Sciences 293
93,68,84,48,293,nursing,Nursing Sciences,93 68 84 48 Nursing Sciences 293
79,47,71,96,293,nursing,Nursing Sciences,79 47 71 96 Nursing Sciences 293
81,64,98,51,294,nursing,Nursing Sciences,81 64 98 51 Nursing Sciences 294
80,74,48,92,294,nursing,Nursing Sciences,80 74 48 92 Nursing Sciences 294
77,92,68,57,294,nursing,Nursing Sciences,77 92 68 57 Nursing Sciences 294
97,99,91,7,294,nursing,Nursing Sciences,97 99 91 7 Nursing Sciences 294
68,76,63,87,294,nursing,Nursing Sciences,68 76 63 87 Nursing Sciences 294
44,71,81,98,294,nursing,Nursing Sciences,44 71 81 98 Nursing Sciences 294
90,98,74,32,294,nursing,Nursing Sciences,90 98 74 32 Nursing Sciences 294
78,96,72,48,294,nursing,Nursing Sciences,78 96 72 48 Nursing Sciences 294
72,73,96,53,294,nursing,Nursing Sciences,72 73 96 53 Nursing Sciences 294
32,79,92,91,294,nursing,Nursing Sciences,32 79 92 91 Nursing Sciences 294
98,41,79,76,294,nursing,Nursing Sciences,98 41 79 76 Nursing Sciences 294
83,57,89,65,294,nursing,Nursing Sciences,83 57 89 65 Nursing Sciences 294
80,75,96,44,295,nursing,Nursing Sciences,80 75 96 44 Nursing Sciences 295
89,91,20,95,295,nursing,Nursing Sciences,89 91 20 95 Nursing Sciences 295
72,83,61,79,295,nursing,Nursing Sciences,72 83 61 79 Nursing Sciences 295
66,69,82,78,295,nursing,Nursing Sciences,66 69 82 78 Nursing Sciences 295
94,61,68,72,295,nursing,Nursing Sciences,94 61 68 72 Nursing Sciences 295
97,73,51,74,295,nursing,Nursing Sciences,97 73 51 74 Nursing Sciences 295
97,66,38,94,295,nursing,Nursing Sciences,97 66 38 94 Nursing Sciences 295
56,61,95,83,295,nursing,Nursing Sciences,56 61 95 83 Nursing Sciences 295
67,69,83,76,295,nursing,Nursing Sciences,67 69 83 76 Nursing Sciences 295
84,58,65,88,295,nursing,Nursing Sciences,84 58 65 88 Nursing Sciences 295
90,48,61,96,295,nursing,Nursing Sciences,90 48 61 96 Nursing Sciences 295
93,81,93,28,295,nursing,Nursing Sciences,93 81 93 28 Nursing Sciences 295
41,88,94,72,295,nursing,Nursing Sciences,41 88 94 72 Nursing Sciences 295
82,50,67,96,295,nursing,Nursing Sciences,82 50 67 96 Nursing Sciences 295
92,50,94,60,296,agricultural extension,Agricultural Sciences,92 50 94 60 Agricultural Sciences 296
98,17,82,99,296,agricultural extension,Agricultural Sciences,98 17 82 99 Agricultural Sciences 296
98,58,87,53,296,agricultural extension,Agricultural Sciences,98 58 87 53 Agricultural Sciences 296
99,20,84,93,296,agricultural extension,Agricultural Sciences,99 20 84 93 Agricultural Sciences 296
55,62,91,88,296,agricultural extension,Agricultural Sciences,55 62 91 88 Agricultural Sciences 296
97,1,99,99,296,agricultural extension,Agricultural Sciences,97 1 99 99 Agricultural Sciences 296
67,71,90,69,297,agricultural extension,Agricultural Sciences,67 71 90 69 Agricultural Sciences 297
45,91,71,90,297,agricultural extension,Agricultural Sciences,45 91 71 90 Agricultural Sciences 297
95,91,33,78,297,agricultural extension,Agricultural Sciences,95 91 33 78 Agricultural Sciences 297
71,74,89,63,297,agricultural extension,Agricultural Sciences,71 74 89 63 Agricultural Sciences 297
44,88,78,87,297,agricultural extension,Agricultural Sciences,44 88 78 87 Agricultural Sciences 297
97,64,41,95,297,agricultural extension,Agricultural Sciences,97 64 41 95 Agricultural Sciences 297
97,97,99,4,297,agricultural extension,Agricultural Sciences,97 97 99 4 Agricultural Sciences 297
97,98,97,5,297,agricultural extension,Agricultural Sciences,97 98 97 5 Agricultural Sciences 297
60,94,56,87,297,agricultural extension,Agricultural Sciences,60 94 56 87 Agricultural Sciences 297
99,98,99,1,297,agricultural extension,Agricultural Sciences,99 98 99 1 Agricultural Sciences 297
71,89,94,43,297,agricultural extension,Agricultural Sciences,71 89 94 43 Agricultural Sciences 297
85,96,45,71,297,agricultural extension,Agricultural Sciences,85 96 45 71 Agricultural Sciences 297
64,69,78,87,298,agricultural extension,Agricultural Sciences,64 69 78 87 Agricultural Sciences 298
82,87,93,36,298,agricultural extension,Agricultural Sciences,82 87 93 36 Agricultural Sciences 298
50,86,87,75,298,agricultural extension,Agricultural Sciences,50 86 87 75 Agricultural Sciences 298
67,96,99,36,298,agricultural extension,Agricultural Sciences,67 96 99 36 Agricultural Sciences 298
96,88,82,32,298,agricultural extension,Agricultural Sciences,96 88 82 32 Agricultural Sciences 298
99,91,97,11,298,agricultural extension,Agricultural Sciences,99 91 97 11 Agricultural Sciences 298
60,69,94,75,298,agricultural extension,Agricultural Sciences,60 69 94 75 Agricultural Sciences 298
84,99,79,36,298,agricultural extension,Agricultural Sciences,84 99 79 36 Agricultural Sciences 298
74,79,95,50,298,agricultural extension,Agricultural Sciences,74 79 95 50 Agricultural Sciences 298
42,88,82,86,298,agricultural extension,Agricultural Sciences,42 88 82 86 Agricultural Sciences 298
94,34,78,92,298,agricultural extension,Agricultural Sciences,94 34 78 92 Agricultural Sciences 298
57,88,62,91,298,agricultural extension,Agricultural Sciences,57 88 62 91 Agricultural Sciences 298
82,76,62,78,298,agricultural extension,Agricultural Sciences,82 76 62 78 Agricultural Sciences 298
98,96,99,5,298,agricultural extension,Agricultural Sciences,98 96 99 5 Agricultural Sciences 298
44,93,98,64,299,agricultural extension,Agricultural Sciences,44 93 98 64 Agricultural Sciences 299
91,66,77,65,299,agricultural extension,Agricultural Sciences,91 66 77 65 Agricultural Sciences 299
69,89,60,81,299,agricultural extension,Agricultural Sciences,69 89 60 81 Agricultural Sciences 299
84,43,95,77,299,agricultural extension,Agricultural Sciences,84 43 95 77 Agricultural Sciences 299
83,90,56,70,299,agricultural extension,Agricultural Sciences,83 90 56 70 Agricultural Sciences 299
72,64,85,78,299,agricultural extension,Agricultural Sciences,72 64 85 78 Agricultural Sciences 299
61,87,57,94,299,agricultural extension,Agricultural Sciences,61 87 57 94 Agricultural Sciences 299
100,96,100,3,299,agricultural extension,Agricultural Sciences,100 96 100 3 Agricultural Sciences 299
89,86,80,44,299,agricultural extension,Agricultural Sciences,89 86 80 44 Agricultural Sciences 299
69,95,66,69,299,agricultural extension,Agricultural Sciences,69 95 66 69 Agricultural Sciences 299
79,99,86,35,299,agricultural extension,Agricultural Sciences,79 99 86 35 Agricultural Sciences 299
52,79,97,71,299,agricultural extension,Agricultural Sciences,52 79 97 71 Agricultural Sciences 299
95,12,93,100,300,agricultural extension,Agricultural Sciences,95 12 93 100 Agricultural Sciences 300
80,65,66,89,300,agricultural extension,Agricultural Sciences,80 65 66 89 Agricultural Sciences 300
55,90,80,75,300,agricultural extension,Agricultural Sciences,55 90 80 75 Agricultural Sciences 300
68,73,76,83,300,agricultural extension,Agricultural Sciences,68 73 76 83 Agricultural Sciences 300
73,56,85,87,301,geology,Mines,73 56 85 87 Mines 301
73,71,57,100,301,geology,Mines,73 71 57 100 Mines 301
97,94,79,31,301,geology,Mines,97 94 79 31 Mines 301
81,73,70,77,301,geology,Mines,81 73 70 77 Mines 301
72,51,82,96,301,geology,Mines,72 51 82 96 Mines 301
92,44,85,80,301,geology,Mines,92 44 85 80 Mines 301
41,100,66,95,302,geology,Mines,41 100 66 95 Mines 302
88,41,76,97,302,geology,Mines,88 41 76 97 Mines 302
81,90,67,64,302,geology,Mines,81 90 67 64 Mines 302
99,96,99,8,302,geology,Mines,99 96 99 8 Mines 302
91,60,51,100,302,geology,Mines,91 60 51 100 Mines 302
75,66,88,73,302,geology,Mines,75 66 88 73 Mines 302
81,92,70,60,303,geology,Mines,81 92 70 60 Mines 303
63,96,93,51,303,geology,Mines,63 96 93 51 Mines 303
76,54,88,85,303,geology,Mines,76 54 88 85 Mines 303
93,58,90,62,303,geology,Mines,93 58 90 62 Mines 303
87,69,63,84,303,geology,Mines,87 69 63 84 Mines 303
69,87,99,48,303,geology,Mines,69 87 99 48 Mines 303
91,32,91,89,303,geology,Mines,91 32 91 89 Mines 303
98,45,100,60,303,geology,Mines,98 45 100 60 Mines 303
77,69,75,83,304,geology,Mines,77 69 75 83 Mines 304
74,62,75,93,304,geology,Mines,74 62 75 93 Mines 304
98,24,92,90,304,geology,Mines,98 24 92 90 Mines 304
89,50,71,94,304,geology,Mines,89 50 71 94 Mines 304
83,70,79,72,304,geology,Mines,83 70 79 72 Mines 304
96,87,74,48,305,geology,Mines,96 87 74 48 Mines 305
90,99,96,20,305,geology,Mines,90 99 96 20 Mines 305
76,82,59,88,305,geology,Mines,76 82 59 88 Mines 305
90,91,83,41,305,geology,Mines,90 91 83 41 Mines 305
88,81,74,62,305,geology,Mines,88 81 74 62 Mines 305
90,93,78,44,305,geology,Mines,90 93 78 44 Mines 305
95,97,95,18,305,geology,Mines,95 97 95 18 Mines 305
92,70,80,63,305,geology,Mines,92 70 80 63 Mines 305
38,74,98,95,305,geology,Mines,38 74 98 95 Mines 305
71,88,92,54,305,geology,Mines,71 88 92 54 Mines 305
35,93,80,97,305,geology,Mines,35 93 80 97 Mines 305
97,97,97,14,305,geology,Mines,97 97 97 14 Mines 305
92,50,87,77,306,nursing,Nursing Sciences,92 50 87 77 Nursing Sciences 306
86,37,83,100,306,nursing,Nursing Sciences,86 37 83 100 Nursing Sciences 306
69,61,95,81,306,nursing,Nursing Sciences,69 61 95 81 Nursing Sciences 306
100,61,95,50,306,nursing,Nursing Sciences,100 61 95 50 Nursing Sciences 306
82,57,78,89,306,nursing,Nursing Sciences,82 57 78 89 Nursing Sciences 306
98,32,92,84,306,nursing,Nursing Sciences,98 32 92 84 Nursing Sciences 306
86,50,95,75,306,nursing,Nursing Sciences,86 50 95 75 Nursing Sciences 306
86,77,95,48,306,nursing,Nursing Sciences,86 77 95 48 Nursing Sciences 306
65,92,100,49,306,nursing,Nursing Sciences,65 92 100 49 Nursing Sciences 306
79,63,77,88,307,nursing,Nursing Sciences,79 63 77 88 Nursing Sciences 307
80,50,82,95,307,nursing,Nursing Sciences,80 50 82 95 Nursing Sciences 307
80,93,54,80,307,nursing,Nursing Sciences,80 93 54 80 Nursing Sciences 307
96,97,97,17,307,nursing,Nursing Sciences,96 97 97 17 Nursing Sciences 307
94,91,44,78,307,nursing,Nursing Sciences,94 91 44 78 Nursing Sciences 307
54,86,89,78,307,nursing,Nursing Sciences,54 86 89 78 Nursing Sciences 307
75,98,86,48,307,nursing,Nursing Sciences,75 98 86 48 Nursing Sciences 307
50,98,78,82,308,nursing,Nursing Sciences,50 98 78 82 Nursing Sciences 308
86,26,99,97,308,nursing,Nursing Sciences,86 26 99 97 Nursing Sciences 308
59,82,74,93,308,nursing,Nursing Sciences,59 82 74 93 Nursing Sciences 308
82,60,74,92,308,nursing,Nursing Sciences,82 60 74 92 Nursing Sciences 308
51,99,99,59,308,nursing,Nursing Sciences,51 99 99 59 Nursing Sciences 308
100,56,100,52,308,nursing,Nursing Sciences,100 56 100 52 Nursing Sciences 308
79,71,82,76,308,nursing,Nursing Sciences,79 71 82 76 Nursing Sciences 308
88,51,79,90,308,nursing,Nursing Sciences,88 51 79 90 Nursing Sciences 308
78,85,76,69,308,nursing,Nursing Sciences,78 85 76 69 Nursing Sciences 308
84,98,94,32,308,nursing,Nursing Sciences,84 98 94 32 Nursing Sciences 308
57,55,97,99,308,nursing,Nursing Sciences,57 55 97 99 Nursing Sciences 308
73,74,76,85,308,nursing,Nursing Sciences,73 74 76 85 Nursing Sciences 308
50,79,86,94,309,nursing,Nursing Sciences,50 79 86 94 Nursing Sciences 309
86,50,86,87,309,nursing,Nursing Sciences,86 50 86 87 Nursing Sciences 309
57,88,88,76,309,nursing,Nursing Sciences,57 88 88 76 Nursing Sciences 309
42,95,79,93,309,nursing,Nursing Sciences,42 95 79 93 Nursing Sciences 309
70,44,98,97,309,nursing,Nursing Sciences,70 44 98 97 Nursing Sciences 309
92,53,85,79,309,nursing,Nursing Sciences,92 53 85 79 Nursing Sciences 309
32,99,81,98,310,nursing,Nursing Sciences,32 99 81 98 Nursing Sciences 310
75,80,91,64,310,nursing,Nursing Sciences,75 80 91 64 Nursing Sciences 310
63,97,74,76,310,nursing,Nursing Sciences,63 97 74 76 Nursing Sciences 310
77,93,46,94,310,nursing,Nursing Sciences,77 93 46 94 Nursing Sciences 310
63,82,79,87,311,vetenary medicine,Agricultural Sciences,63 82 79 87 Agricultural Sciences 311
87,80,65,79,311,vetenary medicine,Agricultural Sciences,87 80 65 79 Agricultural Sciences 311
90,88,52,81,311,vetenary medicine,Agricultural Sciences,90 88 52 81 Agricultural Sciences 311
52,75,90,94,311,vetenary medicine,Agricultural Sciences,52 75 90 94 Agricultural Sciences 311
70,84,91,66,311,vetenary medicine,Agricultural Sciences,70 84 91 66 Agricultural Sciences 311
96,41,74,100,311,vetenary medicine,Agricultural Sciences,96 41 74 100 Agricultural Sciences 311
72,86,60,93,311,vetenary medicine,Agricultural Sciences,72 86 60 93 Agricultural Sciences 311
85,50,88,89,312,vetenary medicine,Agricultural Sciences,85 50 88 89 Agricultural Sciences 312
76,80,79,77,312,vetenary medicine,Agricultural Sciences,76 80 79 77 Agricultural Sciences 312
83,89,83,57,312,vetenary medicine,Agricultural Sciences,83 89 83 57 Agricultural Sciences 312
95,96,56,65,312,vetenary medicine,Agricultural Sciences,95 96 56 65 Agricultural Sciences 312
80,65,73,95,313,vetenary medicine,Agricultural Sciences,80 65 73 95 Agricultural Sciences 313
89,86,84,54,313,vetenary medicine,Agricultural Sciences,89 86 84 54 Agricultural Sciences 313
40,83,91,99,313,vetenary medicine,Agricultural Sciences,40 83 91 99 Agricultural Sciences 313
94,50,77,92,313,vetenary medicine,Agricultural Sciences,94 50 77 92 Agricultural Sciences 313
52,93,84,84,313,vetenary medicine,Agricultural Sciences,52 93 84 84 Agricultural Sciences 313
44,99,80,90,313,vetenary medicine,Agricultural Sciences,44 99 80 90 Agricultural Sciences 313
97,46,76,94,313,vetenary medicine,Agricultural Sciences,97 46 76 94 Agricultural Sciences 313
43,97,76,97,313,vetenary medicine,Agricultural Sciences,43 97 76 97 Agricultural Sciences 313
47,94,91,82,314,vetenary medicine,Agricultural Sciences,47 94 91 82 Agricultural Sciences 314
90,98,42,84,314,vetenary medicine,Agricultural Sciences,90 98 42 84 Agricultural Sciences 314
64,83,79,89,315,vetenary medicine,Agricultural Sciences,64 83 79 89 Agricultural Sciences 315
71,65,97,82,315,vetenary medicine,Agricultural Sciences,71 65 97 82 Agricultural Sciences 315
64,81,100,70,315,vetenary medicine,Agricultural Sciences,64 81 100 70 Agricultural Sciences 315
60,88,91,76,315,vetenary medicine,Agricultural Sciences,60 88 91 76 Agricultural Sciences 315
90,62,68,95,315,vetenary medicine,Agricultural Sciences,90 62 68 95 Agricultural Sciences 315
71,82,71,91,315,vetenary medicine,Agricultural Sciences,71 82 71 91 Agricultural Sciences 315
52,82,88,93,315,vetenary medicine,Agricultural Sciences,52 82 88 93 Agricultural Sciences 315
94,95,60,66,315,vetenary medicine,Agricultural Sciences,94 95 60 66 Agricultural Sciences 315
96,98,94,27,315,vetenary medicine,Agricultural Sciences,96 98 94 27 Agricultural Sciences 315
90,80,62,83,315,vetenary medicine,Agricultural Sciences,90 80 62 83 Agricultural Sciences 315
77,61,96,81,315,vetenary medicine,Agricultural Sciences,77 61 96 81 Agricultural Sciences 315
81,72,91,72,316,physiotherapy,Health Sciences,81 72 91 72 Health Sciences 316
48,93,87,88,316,physiotherapy,Health Sciences,48 93 87 88 Health Sciences 316
78,83,80,75,316,physiotherapy,Health Sciences,78 83 80 75 Health Sciences 316
78,66,89,83,316,physiotherapy,Health Sciences,78 66 89 83 Health Sciences 316
99,45,86,86,316,physiotherapy,Health Sciences,99 45 86 86 Health Sciences 316
78,92,55,91,316,physiotherapy,Health Sciences,78 92 55 91 Health Sciences 316
70,93,65,88,316,physiotherapy,Health Sciences,70 93 65 88 Health Sciences 316
92,86,69,70,317,physiotherapy,Health Sciences,92 86 69 70 Health Sciences 317
78,99,70,70,317,physiotherapy,Health Sciences,78 99 70 70 Health Sciences 317
92,75,91,59,317,physiotherapy,Health Sciences,92 75 91 59 Health Sciences 317
95,87,47,88,317,physiotherapy,Health Sciences,95 87 47 88 Health Sciences 317
43,98,98,79,318,physiotherapy,Health Sciences,43 98 98 79 Health Sciences 318
91,72,88,67,318,physiotherapy,Health Sciences,91 72 88 67 Health Sciences 318
82,77,68,91,318,physiotherapy,Health Sciences,82 77 68 91 Health Sciences 318
81,77,87,73,318,physiotherapy,Health Sciences,81 77 87 73 Health Sciences 318
97,72,100,49,318,physiotherapy,Health Sciences,97 72 100 49 Health Sciences 318
60,93,86,79,318,physiotherapy,Health Sciences,60 93 86 79 Health Sciences 318
51,96,85,87,319,physiotherapy,Health Sciences,51 96 85 87 Health Sciences 319
93,96,99,31,319,physiotherapy,Health Sciences,93 96 99 31 Health Sciences 319
97,41,92,89,319,physiotherapy,Health Sciences,97 41 92 89 Health Sciences 319
84,84,66,85,319,physiotherapy,Health Sciences,84 84 66 85 Health Sciences 319
83,77,74,85,319,physiotherapy,Health Sciences,83 77 74 85 Health Sciences 319
77,70,83,89,319,physiotherapy,Health Sciences,77 70 83 89 Health Sciences 319
81,83,85,70,319,physiotherapy,Health Sciences,81 83 85 70 Health Sciences 319
100,68,89,63,320,physiotherapy,Health Sciences,100 68 89 63 Health Sciences 320
79,59,88,94,320,physiotherapy,Health Sciences,79 59 88 94 Health Sciences 320
79,90,66,85,320,physiotherapy,Health Sciences,79 90 66 85 Health Sciences 320
61,82,81,97,321,agricultural economics,Agricultural Sciences,61 82 81 97 Agricultural Sciences 321
45,100,79,97,321,agricultural economics,Agricultural Sciences,45 100 79 97 Agricultural Sciences 321
89,67,81,84,321,agricultural economics,Agricultural Sciences,89 67 81 84 Agricultural Sciences 321
70,91,91,69,321,agricultural economics,Agricultural Sciences,70 91 91 69 Agricultural Sciences 321
63,90,72,97,322,agricultural economics,Agricultural Sciences,63 90 72 97 Agricultural Sciences 322
83,75,86,78,322,agricultural economics,Agricultural Sciences,83 75 86 78 Agricultural Sciences 322
92,95,69,66,322,agricultural economics,Agricultural Sciences,92 95 69 66 Agricultural Sciences 322
96,75,80,71,322,agricultural economics,Agricultural Sciences,96 75 80 71 Agricultural Sciences 322
93,67,79,83,322,agricultural economics,Agricultural Sciences,93 67 79 83 Agricultural Sciences 322
96,50,86,91,323,agricultural economics,Agricultural Sciences,96 50 86 91 Agricultural Sciences 323
77,82,77,87,323,agricultural economics,Agricultural Sciences,77 82 77 87 Agricultural Sciences 323
87,79,84,73,323,agricultural economics,Agricultural Sciences,87 79 84 73 Agricultural Sciences 323
76,87,80,80,323,agricultural economics,Agricultural Sciences,76 87 80 80 Agricultural Sciences 323
99,69,94,61,323,agricultural economics,Agricultural Sciences,99 69 94 61 Agricultural Sciences 323
90,88,48,98,324,agricultural economics,Agricultural Sciences,90 88 48 98 Agricultural Sciences 324
69,83,78,95,325,agricultural economics,Agricultural Sciences,69 83 78 95 Agricultural Sciences 325
90,68,97,70,325,agricultural economics,Agricultural Sciences,90 68 97 70 Agricultural Sciences 325
76,100,50,100,326,electrical & electronic engineering,Engineering,76 100 50 100 Engineering 326
42,97,93,94,326,electrical & electronic engineering,Engineering,42 97 93 94 Engineering 326
64,99,68,96,327,electrical & electronic engineering,Engineering,64 99 68 96 Engineering 327
89,89,87,62,327,electrical & electronic engineering,Engineering,89 89 87 62 Engineering 327
92,59,88,89,328,electrical & electronic engineering,Engineering,92 59 88 89 Engineering 328
62,86,88,92,328,electrical & electronic engineering,Engineering,62 86 88 92 Engineering 328
70,81,99,78,328,electrical & electronic engineering,Engineering,70 81 99 78 Engineering 328
87,91,57,93,328,electrical & electronic engineering,Engineering,87 91 57 93 Engineering 328
76,87,80,86,329,electrical & electronic engineering,Engineering,76 87 80 86 Engineering 329
50,96,91,92,329,electrical & electronic engineering,Engineering,50 96 91 92 Engineering 329
90,92,61,86,329,electrical & electronic engineering,Engineering,90 92 61 86 Engineering 329
66,78,99,87,330,electrical & electronic engineering,Engineering,66 78 99 87 Engineering 330
97,90,87,56,330,electrical & electronic engineering,Engineering,97 90 87 56 Engineering 330
89,78,87,76,330,electrical & electronic engineering,Engineering,89 78 87 76 Engineering 330
99,83,66,83,331,mining engineering,Mines,99 83 66 83 Mines 331
100,84,78,69,331,mining engineering,Mines,100 84 78 69 Mines 331
86,94,84,67,331,mining engineering,Mines,86 94 84 67 Mines 331
82,75,93,81,331,mining engineering,Mines,82 75 93 81 Mines 331
69,93,75,94,331,mining engineering,Mines,69 93 75 94 Mines 331
73,70,93,96,332,mining engineering,Mines,73 70 93 96 Mines 332
86,82,81,83,332,mining engineering,Mines,86 82 81 83 Mines 332
50,94,99,89,332,mining engineering,Mines,50 94 99 89 Mines 332
89,85,70,88,332,mining engineering,Mines,89 85 70 88 Mines 332
80,66,94,93,333,mining engineering,Mines,80 66 94 93 Mines 333
94,96,54,89,333,mining engineering,Mines,94 96 54 89 Mines 333
85,76,85,87,333,mining engineering,Mines,85 76 85 87 Mines 333
96,91,68,78,333,mining engineering,Mines,96 91 68 78 Mines 333
89,92,88,64,333,mining engineering,Mines,89 92 88 64 Mines 333
93,99,78,63,333,mining engineering,Mines,93 99 78 63 Mines 333
97,50,93,93,333,mining engineering,Mines,97 50 93 93 Mines 333
83,73,100,78,334,mining engineering,Mines,83 73 100 78 Mines 334
96,59,88,91,334,mining engineering,Mines,96 59 88 91 Mines 334
66,94,89,85,334,mining engineering,Mines,66 94 89 85 Mines 334
97,66,97,74,334,mining engineering,Mines,97 66 97 74 Mines 334
91,79,71,94,335,mining engineering,Mines,91 79 71 94 Mines 335
76,82,100,77,335,mining engineering,Mines,76 82 100 77 Mines 335
84,67,90,95,336,mechanical engineering,Engineering,84 67 90 95 Engineering 336
54,90,93,99,336,mechanical engineering,Engineering,54 90 93 99 Engineering 336
71,95,75,95,336,mechanical engineering,Engineering,71 95 75 95 Engineering 336
97,73,68,98,336,mechanical engineering,Engineering,97 73 68 98 Engineering 336
67,81,93,95,336,mechanical engineering,Engineering,67 81 93 95 Engineering 336
90,79,87,80,336,mechanical engineering,Engineering,90 79 87 80 Engineering 336
98,46,100,93,337,mechanical engineering,Engineering,98 46 100 93 Engineering 337
99,65,99,74,337,mechanical engineering,Engineering,99 65 99 74 Engineering 337
82,90,65,100,337,mechanical engineering,Engineering,82 90 65 100 Engineering 337
52,94,99,92,337,mechanical engineering,Engineering,52 94 99 92 Engineering 337
92,80,75,90,337,mechanical engineering,Engineering,92 80 75 90 Engineering 337
91,76,83,87,337,mechanical engineering,Engineering,91 76 83 87 Engineering 337
91,82,72,93,338,mechanical engineering,Engineering,91 82 72 93 Engineering 338
67,100,77,94,338,mechanical engineering,Engineering,67 100 77 94 Engineering 338
82,90,68,98,338,mechanical engineering,Engineering,82 90 68 98 Engineering 338
77,85,97,79,338,mechanical engineering,Engineering,77 85 97 79 Engineering 338
92,90,69,87,338,mechanical engineering,Engineering,92 90 69 87 Engineering 338
88,88,68,94,338,mechanical engineering,Engineering,88 88 68 94 Engineering 338
100,77,83,78,338,mechanical engineering,Engineering,100 77 83 78 Engineering 338
81,80,89,89,339,mechanical engineering,Engineering,81 80 89 89 Engineering 339
81,83,94,81,339,mechanical engineering,Engineering,81 83 94 81 Engineering 339
99,97,100,43,339,mechanical engineering,Engineering,99 97 100 43 Engineering 339
82,83,77,97,339,mechanical engineering,Engineering,82 83 77 97 Engineering 339
97,61,94,87,339,mechanical engineering,Engineering,97 61 94 87 Engineering 339
90,91,72,86,339,mechanical engineering,Engineering,90 91 72 86 Engineering 339
68,87,84,100,339,mechanical engineering,Engineering,68 87 84 100 Engineering 339
70,98,85,86,339,mechanical engineering,Engineering,70 98 85 86 Engineering 339
92,76,100,71,339,mechanical engineering,Engineering,92 76 100 71 Engineering 339
98,65,83,95,341,mathematics,Natural Sciences,98 65 83 95 Natural Sciences 341
94,57,93,97,341,mathematics,Natural Sciences,94 57 93 97 Natural Sciences 341
81,82,83,95,341,mathematics,Natural Sciences,81 82 83 95 Natural Sciences 341
98,56,90,98,342,mathematics,Natural Sciences,98 56 90 98 Natural Sciences 342
85,73,100,84,342,mathematics,Natural Sciences,85 73 100 84 Natural Sciences 342
97,76,89,80,342,mathematics,Natural Sciences,97 76 89 80 Natural Sciences 342
88,78,92,85,343,mathematics,Natural Sciences,88 78 92 85 Natural Sciences 343
99,96,86,63,344,mathematics,Natural Sciences,99 96 86 63 Natural Sciences 344
78,100,92,75,345,mathematics,Natural Sciences,78 100 92 75 Natural Sciences 345
91,89,81,86,347,pharmacy,Health Sciences,91 89 81 86 Health Sciences 347
74,84,100,90,348,pharmacy,Health Sciences,74 84 100 90 Health Sciences 348
62,89,100,97,348,pharmacy,Health Sciences,62 89 100 97 Health Sciences 348
97,99,64,89,349,pharmacy,Health Sciences,97 99 64 89 Health Sciences 349
91,93,99,67,350,pharmacy,Health Sciences,91 93 99 67 Health Sciences 350
99,98,69,85,351,actuarial science,Natural Sciences,99 98 69 85 Natural Sciences 351
82,76,95,99,352,actuarial science,Natural Sciences,82 76 95 99 Natural Sciences 352
95,95,98,66,354,actuarial science,Natural Sciences,95 95 98 66 Natural Sciences 354
92,84,81,98,355,actuarial science,Natural Sciences,92 84 81 98 Natural Sciences 355
97,81,96,81,355,actuarial science,Natural Sciences,97 81 96 81 Natural Sciences 355
98,93,99,65,355,actuarial science,Natural Sciences,98 93 99 65 Natural Sciences 355
95,98,70,93,356,computer science,Natural Sciences,95 98 70 93 Natural Sciences 356
95,84,81,97,357,computer science,Natural Sciences,95 84 81 97 Natural Sciences 357
87,87,96,87,357,computer science,Natural Sciences,87 87 96 87 Natural Sciences 357
95,94,96,75,360,computer science,Natural Sciences,95 94 96 75 Natural Sciences 360
90,100,91,83,364,physics,Natural Sciences,90 100 91 83 Natural Sciences 364
93,93,94,84,364,physics,Natural Sciences,93 93 94 84 Natural Sciences 364
90,84,97,94,365,physics,Natural Sciences,90 84 97 94 Natural Sciences 365
90,85,100,91,366,physics,Natural Sciences,90 85 100 91 Natural Sciences 366
92,91,96,87,366,physics,Natural Sciences,92 91 96 87 Natural Sciences 366
95,95,83,94,367,physics,Natural Sciences,95 95 83 94 Natural Sciences 367
83,94,94,96,367,physics,Natural Sciences,83 94 94 96 Natural Sciences 367
90,98,85,95,368,physics,Natural Sciences,90 98 85 95 Natural Sciences 368
99,95,97,82,373,civil and environment engineering,Engineering,99 95 97 82 Engineering 373
88,100,89,100,377,civil and environment engineering,Engineering,88 100 89 100 Engineering 377
100,90,100,90,380,civil and environment engineering,Engineering,100 90 100 90 Engineering 380
92,89,100,100,381,medicine & surgery,Medicine,92 89 100 100 Medicine 381
97,100,96,100,393,medicine & surgery,Medicine,97 100 96 100 Medicine 393
100,100,100,100,400,medicine & surgery,Medicine,100 100 100 100 Medicine 400
